工	a
了	b
以	c
在	d
有	e
地	f
一	g
上	h
不	i
是	j
中	k
国	l
同	m
民	n
为	o
这	p
我	q
的	r
要	s
和	t
产	u
发	v
人	w
经	x
主	y
式	aa
节	ab
芭	ac
基	ad
菜	ae
革	af
七	ag
牙	ah
东	ai
划	aj
或	ak
功	al
贡	am
世	an
蒌	ao
芝	ap
区	aq
匠	ar
苛	as
攻	at
燕	au
切	av
共	aw
药	ax
芳	ay
陈	ba
子	bb
取	bc
承	bd
阴	be
际	bf
卫	bg
耻	bh
孙	bi
阳	bj
职	bk
阵	bl
出	bm
也	bn
耿	bo
辽	bp
隐	bq
孤	br
阿	bs
降	bt
联	bu
限	bv
队	bw
陛	bx
防	by
戏	ca
邓	cb
双	cc
参	cd
能	ce
对	cf
骊	cg
骒	cj
台	ck
劝	cl
观	cm
马	cn
驼	cp
允	cq
牟	cr
骠	cs
矣	ct
骈	cu
艰	cv
难	cw
驻	cy
左	da
顾	db
友	dc
大	dd
胡	de
夺	df
三	dg
丰	dh
砂	di
百	dj
右	dk
历	dl
面	dm
成	dn
灰	do
达	dp
克	dq
原	dr
厅	ds
帮	dt
磁	du
肆	dv
春	dw
龙	dx
太	dy
肛	ea
服	eb
肥	ec
须	ed
朋	ee
肝	ef
且	eg
鼐	eh
膛	ei
胆	ej
肿	ek
肋	el
肌	em
甩	en
膦	eo
爱	ep
胸	eq
遥	er
采	es
用	et
胶	eu
妥	ev
脸	ew
脂	ex
及	ey
载	fa
地	fb
支	fc
城	fd
圾	fe
寺	ff
二	fg
直	fh
示	fi
进	fj
吉	fk
协	fl
南	fm
志	fn
赤	fo
过	fp
无	fq
垢	fr
霜	fs
才	ft
增	fu
雪	fv
夫	fw
坳	fx
坟	fy
开	ga
屯	gb
到	gc
天	gd
表	ge
于	gf
五	gg
下	gh
不	gi
理	gj
事	gk
画	gl
现	gm
与	gn
来	go
列	gq
珠	gr
末	gs
玫	gt
平	gu
妻	gv
珍	gw
互	gx
玉	gy
虎	ha
齰	hb
皮	hc
睚	hd
肯	he
睦	hf
睛	hg
止	hh
步	hi
旧	hj
占	hk
卤	hl
贞	hm
卢	hn
眯	ho
瞎	hp
餐	hq
睥	hr
盯	hs
睡	ht
瞳	hu
眼	hv
具	hw
此	hx
眩	hy
江	ia
池	ib
汉	ic
尖	id
肖	ie
法	if
汪	ig
小	ih
水	ii
浊	ij
澡	ik
渐	il
没	im
沁	in
淡	io
学	ip
光	iq
泊	ir
洒	is
少	it
洋	iu
当	iv
兴	iw
涨	ix
注	iy
虹	ja
最	jb
紧	jc
晨	jd
明	je
时	jf
量	jg
早	jh
晃	ji
昌	jj
蝇	jk
曙	jl
遇	jm
电	jn
显	jo
晕	jp
晚	jq
蝗	jr
果	js
昨	jt
暗	ju
归	jv
蛤	jw
昆	jx
景	jy
呀	ka
啊	kb
吧	kc
顺	kd
吸	ke
叶	kf
呈	kg
中	kh
吵	ki
虽	kj
吕	kk
另	kl
员	km
叫	kn
咪	ko
喧	kp
史	kq
听	kr
呆	ks
呼	kt
啼	ku
哪	kv
只	kw
哟	kx
嘛	ky
轼	la
囝	lb
轻	lc
因	ld
胃	le
轩	lf
车	lg
四	lh
辊	lj
加	lk
男	ll
轴	lm
思	ln
辚	lo
边	lp
罗	lq
斩	lr
困	ls
力	lt
较	lu
轨	lv
办	lw
累	lx
罚	ly
曲	ma
邮	mb
凤	mc
央	md
骨	me
财	mf
同	mg
由	mh
峭	mi
则	mj
迥	mk
崭	ml
册	mm
岂	mn
嶙	mo
迪	mp
风	mq
贩	mr
朵	ms
几	mt
赠	mu
内	mw
嶷	mx
凡	my
民	na
敢	nb
怪	nc
居	nd
导	nf
怀	ng
收	nh
悄	ni
慢	nj
避	nk
惭	nl
届	nm
忆	nn
屡	no
忱	np
懈	nq
怕	nr
怵	ns
必	nt
习	nu
恨	nv
愉	nw
尼	nx
心	ny
煤	oa
籽	ob
烃	oc
类	od
粗	oe
灶	of
业	og
粘	oh
炒	oi
烛	oj
炽	ok
烟	ol
灿	om
断	on
炎	oo
迷	op
炮	oq
煌	or
灯	os
烽	ot
料	ou
娄	ov
粉	ow
糨	ox
米	oy
宽	pa
字	pb
害	pd
家	pe
守	pf
定	pg
寂	ph
宵	pi
审	pj
宫	pk
军	pl
宙	pm
官	pn
灾	po
之	pp
宛	pq
宾	pr
宁	ps
客	pt
实	pu
安	pv
空	pw
它	px
社	py
氏	qa
凶	qb
色	qc
然	qd
角	qe
针	qf
钱	qg
外	qh
乐	qi
旬	qj
名	qk
甸	ql
负	qm
包	qn
炙	qo
锭	qp
多	qq
铁	qr
钉	qs
儿	qt
匀	qu
争	qv
欠	qw
镪	qx
久	qy
找	ra
报	rb
反	rc
拓	rd
扔	re
持	rf
后	rg
年	rh
朱	ri
提	rj
扣	rk
押	rl
抽	rm
所	rn
搂	ro
近	rp
换	rq
折	rr
打	rs
手	rt
拉	ru
扫	rv
失	rw
批	rx
扩	ry
械	sa
李	sb
权	sc
枯	sd
极	se
村	sf
本	sg
相	sh
档	si
查	sj
可	sk
楞	sl
机	sm
杨	sn
杰	so
棕	sp
构	sq
析	sr
林	ss
格	st
样	su
要	sv
检	sw
楷	sx
术	sy
长	ta
季	tb
么	tc
知	td
秀	te
行	tf
生	tg
处	th
秒	ti
得	tj
各	tk
务	tl
向	tm
秘	tn
秋	to
管	tp
称	tq
物	tr
条	ts
笔	tt
科	tu
委	tv
答	tw
第	tx
入	ty
并	ua
闻	ub
冯	uc
关	ud
前	ue
半	uf
闰	ug
站	uh
冰	ui
间	uj
部	uk
曾	ul
商	um
决	un
普	uo
帝	up
交	uq
瓣	ur
亲	us
产	ut
立	uu
妆	uv
闪	uw
北	ux
六	uy
毁	va
好	vb
妈	vc
姑	vd
奶	ve
寻	vf
姨	vg
叟	vh
录	vi
旭	vj
如	vk
舅	vl
妯	vm
刀	vn
灵	vo
巡	vp
婚	vq
姝	vr
杂	vs
九	vt
嫌	vu
妇	vv
臾	vw
姆	vx
妨	vy
代	wa
他	wb
公	wc
估	wd
仍	we
会	wf
全	wg
个	wh
偿	wi
介	wj
保	wk
佃	wl
仙	wm
亿	wn
伙	wo
侬	wp
你	wq
伯	wr
休	ws
作	wt
们	wu
分	wv
从	ww
化	wx
信	wy
红	xa
弛	xb
经	xc
顷	xd
级	xe
结	xf
线	xg
引	xh
纱	xi
旨	xj
强	xk
细	xl
纲	xm
纪	xn
继	xo
综	xp
约	xq
绵	xr
缥	xs
张	xt
弱	xu
绿	xv
给	xw
比	xx
纺	xy
度	ya
离	yb
充	yc
庆	yd
衣	ye
计	yf
主	yg
让	yh
就	yi
刘	yj
训	yk
为	yl
高	ym
记	yn
变	yo
这	yp
义	yq
诉	yr
订	ys
放	yt
说	yu
良	yv
认	yw
率	yx
方	yy
工	aaa
匞	aad
式	aad
苷	aaf
芽	aah
戒	aak
苣	aan
戔	aar
荛	aat
芅	aau
荫	abe
芓	abf
茸	abf
卭	abh
邛	abh
蒸	abi
节	abj
茁	abm
芤	abn
菰	abr
萨	abu
匜	abv
茎	aca
芭	acb
苔	ack
䔍	acu
莽	ada
苊	adb
茇	adc
弎	add
戎	ade
苦	adf
葳	adg
荐	adh
藉	adi
菲	adj
若	adk
苈	adl
项	adm
茂	adn
芖	adu
蕨	adu
其	adw
茏	adx
艿	aeb
藐	aee
苴	aeg
苚	aej
菜	aes
㣉	aet
散	aet
藤	aeu
荽	aev
芨	aey
鞯	afa
邯	afb
靶	afc
弍	afd
甘	afd
芏	aff
蒜	afi
芉	afj
革	afj
勒	afl
贰	afm
苇	afn
鞍	afp
鞠	afq
靳	afr
某	afs
著	aft
蔷	afu
鞭	afw
荆	aga
匡	agd
弌	agd
莆	age
芋	agf
廿	agh
苤	agi
蕙	agj
蔌	agk
芾	agm
七	agn
匚	agn
匸	agn
莱	ago
葬	agq
茉	ags
廾	agt
苹	agu
萋	agv
荑	agx
蘧	aha
䒙	ahf
芷	ahf
苜	ahf
菽	ahi
㐄	ahk
苫	ahk
臣	ahn
牙	aht
茈	ahx
茳	aia
范	aib
菹	aie
薄	aig
菠	aih
东	aii
藻	aik
荡	ain
鸫	aiq
蒎	air
菏	ais
落	ait
䒕	aiu
汞	aiu
茫	aiy
蕞	ajb
莫	ajd
萌	aje
䒤	ajf
昔	ajf
㓚	ajh
划	ajh
草	ajj
蔓	ajl
葛	ajq
蓝	ajt
茧	aju
郾	ajv
葺	akb
叵	akd
戓	akd
或	akg
匮	akh
颧	akk
莴	akm
艻	alb
茵	ald
苗	alf
莗	alj
匣	alk
荔	all
功	aln
莲	alp
萝	alq
菌	alt
匦	alv
苏	alw
芁	amb
芟	amc
英	amd
苒	amf
苖	amf
茼	amg
匝	amh
苘	amk
苋	amq
貢	amu
貣	amu
贡	amu
黄	amw
巩	amy
苠	ana
艺	anb
芑	anb
巨	and
蔚	anf
蔬	anh
忒	ani
薜	ank
贳	anm
蕊	ann
芯	anu
世	anv
蓼	anw
苡	any
炗	aou
苂	aou
蒌	aov
菪	apd
蒙	apg
荥	api
萤	apj
营	apk
劳	apl
茕	apn
荧	apo
莺	apq
荦	apr
荣	aps
芝	apu
蓉	apw
萦	apx
芪	aqa
苑	aqb
菳	aqf
葡	aqg
区	aqi
荀	aqj
敬	aqk
殴	aqm
苞	aqn
菊	aqo
欧	aqq
萄	aqr
获	aqt
艾	aqu
芕	aqu
兂	aqv
匹	aqv
旡	aqv
芡	aqw
芍	aqy
葩	arc
菝	ard
苩	arf
茱	ari
芹	arj
匠	ark
萆	art
茜	asf
苯	asg
葙	ash
艼	asj
蕈	asj
苛	ask
菥	asr
㭉	asu
菘	asw
苌	ata
医	atd
莠	ate
芊	atf
董	atg
蓰	ath
莉	atj
蓖	atl
薇	atm
蕃	ato
藜	atq
莪	atr
䒘	atu
䒩	atu
萎	atv
莓	atx
攻	aty
蒴	aub
苙	auf
菛	auf
莘	auj
菩	auk
蔽	aum
蒂	aup
蒋	auq
薪	aus
蒺	aut
蒹	auv
蔺	auw
艽	avb
芀	avb
菇	avd
茛	ave
荨	avf
萧	avi
茹	avk
㓛	avn
切	avn
萸	avw
芄	avy
苍	awb
蓊	awc
茯	awd
蔡	awf
葵	awg
莜	awh
芥	awj
葆	awk
巷	awn
茶	aws
荼	awt
䒔	awu
共	awu
芬	awv
巫	aww
花	awx
蕉	awy
荭	axa
芎	axb
荮	axf
莼	axg
蕴	axj
药	axq
芗	axt
芘	axx
蔗	aya
芳	ayb
茺	ayc
䓂	ayf
苄	ayh
蔼	ayj
蓑	ayk
蒿	aym
芒	ayn
葶	ayp
蘑	ays
蔟	ayt
芠	ayu
莨	ayv
萃	ayw
蓄	ayx
陈	bai
聀	bat
子	bbb
陬	bbc
䦻	bbg
孖	bbg
聑	bbg
耶	bbh
阤	bbn
陉	bca
聂	bcc
聚	bct
娶	bcv
䧞	bcy
取	bcy
隋	bda
随	bde
承	bdi
陌	bdj
陇	bdx
䎳	beg
阴	beg
孺	bfd
䦹	bfh
陡	bfh
际	bfi
阱	bfj
陆	bfm
阮	bfq
陵	bfw
卫	bgd
孒	bgd
耳	bgh
隔	bgk
陋	bgm
阢	bgq
陕	bgu
陂	bhc
耻	bhg
阯	bhg
陟	bhi
屮	bhk
函	bib
丞	big
氶	bii
隙	bij
逊	bip
孙	biy
阥	biy
陧	bjf
阳	bjg
刵	bjh
隅	bjm
隰	bjx
亟	bkc
叾	bkf
聩	bkh
陨	bkm
职	bkw
孟	blf
䧃	blg
阵	blh
陣	blh
勐	bll
阞	bln
祟	bmf
聘	bmg
出	bmk
粜	bmo
孭	bmy
了	bnh
凵	bnh
卩	bnh
阝	bnh
㔾	bnn
䎲	bnn
孔	bnn
巜	bnn
耴	bnn
孞	bnu
恥	bny
耿	boy
阦	boy
䢊	bpd
院	bpf
辽	bpk
耽	bpq
聍	bps
迆	bpv
陀	bpx
孢	bqn
陶	bqr
聊	bqt
陷	bqv
孤	brc
隍	brg
隗	brq
陴	brt
䧈	bsg
䦺	bsh
耵	bsh
阿	bsk
降	bta
聒	btd
阡	btf
隆	btg
阼	bth
孜	bty
联	bud
隧	bue
障	buj
陪	buk
隘	buw
限	bve
附	bwf
险	bwg
阶	bwj
除	bwt
队	bwy
陛	bxx
卪	byi
孓	byi
防	byn
颈	cad
弁	caj
馵	caj
劲	cal
迳	cap
驱	caq
戏	cat
巯	cay
骤	cbc
预	cbd
駬	cbg
䣕	cbh
邓	cbh
予	cbj
馳	cbn
驰	cbn
豫	cbq
矛	cbt
又	ccc
骖	ccd
驿	ccf
骀	cck
㕕	ccu
㕛	ccu
骏	ccw
厸	ccy
双	ccy
馭	ccy
騳	ccy
驭	ccy
叁	cdd
参	cde
畚	cdl
骑	cds
䭾	cdy
馱	cdy
驮	cdy
䏍	cef
驵	ceg
甬	cej
勇	cel
恿	cen
通	cep
能	cex
圣	cff
馯	cfh
䭴	cfj
怼	cfn
对	cfy
骊	cgm
厼	ciu
馹	cjg
驲	cjg
骒	cjs
邰	ckb
台	ckf
馴	ckh
驯	ckh
怠	ckn
炱	cko
迨	ckp
驶	ckq
駟	clg
驷	clg
劝	cln
骡	clx
駎	cmg
骋	cmg
岊	cmj
观	cmq
貟	cmu
贠	cmu
骣	cnb
巴	cnh
马	cnn
厶	cny
龴	cny
遤	cpi
驼	cpx
允	cqb
驹	cqk
驳	cqq
驺	cqv
欢	cqw
鸡	cqy
牟	crh
馸	crh
骠	csf
矣	ctd
骆	ctk
骢	ctl
駇	cty
骈	cua
騂	cuh
骍	cuh
骥	cux
艰	cve
驸	cwf
验	cwg
逡	cwt
骅	cwx
难	cwy
驻	cyg
叉	cyi
蚤	cyj
骧	cyk
驴	cyn
馼	cyy
左	daf
矼	dag
砑	dah
礴	dai
㚏	daj
厝	daj
磺	dam
碟	dan
礞	dap
奁	daq
䂝	dat
硗	dat
砌	dav
礤	daw
硭	day
顾	dbd
耷	dbf
矷	dbg
䂙	dbh
㚎	dbj
础	dbm
厄	dbv
夿	dcb
磉	dcc
碜	dcd
码	dcg
㕝	dcu
厷	dcu
厺	dcu
友	dcu
犮	dcu
雄	dcw
碼	dcy
㕆	ddd
磊	ddd
砳	ddg
碱	ddg
厦	ddh
厌	ddi
厣	ddl
硕	ddm
厉	ddn
魇	ddr
㚐	ddu
套	ddu
餍	ddw
㹜	ddy
夶	ddy
郁	deb
硼	dee
有	def
胡	deg
砽	deh
髭	deh
鬟	del
髯	dem
鬃	dep
鹕	deq
髟	det
長	deu
鬈	deu
髹	dew
奔	dfa
磕	dfc
圧	dfd
辰	dfe
圶	dff
夳	dff
硅	dff
矸	dfh
奈	dfi
夲	dfj
厈	dfk
夸	dfn
奢	dft
夺	dfu
压	dfy
研	dga
砘	dgb
三	dgg
古	dgh
硬	dgj
咸	dgk
礓	dgl
碛	dgm
戌	dgn
丆	dgt
厂	dgt
砰	dgu
威	dgv
碡	dgx
戛	dha
存	dhb
破	dhc
慧	dhd
在	dhf
砋	dhg
戚	dhi
丰	dhk
艳	dhq
夏	dht
契	dhv
耔	dib
耙	dic
耨	did
硝	die
耕	dif
耒	dii
耦	dij
耜	din
耧	dio
砂	dit
夵	diu
泵	diu
耠	diw
砅	diy
耱	diy
厚	djb
非	djd
百	djf
碍	djg
矵	djh
砷	djh
夰	djj
奄	djn
碣	djq
右	dkf
夻	dkf
夼	dkj
夯	dlb
奋	dlf
䦉	dlg
砗	dlh
硨	dlh
㕅	dlk
厍	dlk
厙	dlk
劯	dln
历	dlv
碘	dma
冇	dmb
碳	dmd
碉	dmf
硐	dmg
布	dmh
㞭	dmj
而	dmj
矶	dmn
砚	dmq
頁	dmu
页	dmu
矾	dmy
碾	dna
乭	dnb
臧	dnd
䎁	dng
嘏	dnh
趸	dnk
劢	dnl
成	dnn
迈	dnp
尥	dnq
砀	dnr
怘	dnu
万	dnv
尢	dnv
尤	dnv
尬	dnw
戊	dny
盔	dol
磷	doq
灰	dou
达	dpi
迖	dpi
碗	dpq
牵	dpr
砣	dpx
克	dqb
㕋	dqd
兢	dqd
确	dqe
碒	dqg
砾	dqi
爽	dqq
砍	dqw
矽	dqy
砶	drg
斫	drh
原	dri
碑	drt
硒	dsg
厢	dsh
矴	dsh
碴	dsj
厅	dsk
㚓	dsu
䂞	dsu
邦	dtb
寿	dtf
砟	dth
硌	dtk
硇	dtl
砭	dtp
硪	dtr
故	dty
磙	duc
㕇	dud
磋	dud
砬	dug
辜	duj
厗	duk
碚	duk
碰	duo
磅	dup
冭	duu
磁	dux
厩	dvc
肆	dvf
碌	dvi
砼	dwa
奉	dwf
奏	dwg
仄	dwi
春	dwj
秦	dwt
舂	dwv
雁	dww
礁	dwy
龚	dxa
㔫	dxb
聋	dxb
砻	dxd
垄	dxf
砩	dxj
䂗	dxn
龙	dxv
砒	dxx
袭	dxy
礅	dyb
硫	dyc
䂴	dyg
丈	dyi
太	dyi
态	dyn
矿	dyt
碎	dyw
砇	dyy
腻	eaf
肛	eag
胨	eai
腊	eaj
朦	eap
郛	ebb
服	ebc
孕	ebf
孚	ebf
䏪	ebg
乳	ebn
肔	ebn
胫	eca
夃	eci
胎	eck
盈	ecl
肥	ecn
豝	ecn
肱	edc
呄	edf
胯	edf
须	edm
腠	edw
胧	edx
肰	edy
肽	edy
貘	eea
脬	eeb
貊	eed
月	eee
豺	eef
朋	eeg
豳	eem
燹	eeo
鹏	eeq
豸	eer
肜	eet
貂	eev
貅	eew
豚	eey
豩	eey
肢	efc
䝅	efg
肚	efg
肝	efh
肼	efj
膨	efk
腩	efm
肟	efn
脖	efp
朊	efq
爰	eft
寽	efu
肤	efw
肘	efy
肫	egb
县	egc
且	egd
脯	ege
胚	egi
膈	egk
助	egl
肺	egm
豕	egt
雎	egw
胰	egx
胩	ehh
丯	ehk
鼐	ehn
辵	ehu
膛	eip
胱	eiq
尕	eiu
㸓	ejf
胆	ejg
刖	ejh
腽	ejl
腥	ejt
肿	ekh
腭	ekk
脶	ekm
胭	eld
䀃	elf
盁	elf
胛	elh
肋	eln
爵	elv
胁	elw
腆	ema
股	emc
胴	emg
肌	emn
觅	emq
肭	emw
㐍	enb
脲	eni
肊	enn
肠	enr
甩	env
膦	eoq
脒	eoy
受	epc
爱	epd
迌	epd
脓	epe
脘	epf
腚	epg
逐	epi
腕	epq
膑	epr
胺	epv
辸	epv
腔	epw
胝	eqa
脆	eqd
朐	eqk
胞	eqn
胸	eqq
脎	eqs
肷	eqw
胍	erc
胉	erg
肵	erh
腺	eri
遥	erm
脾	ert
彩	ese
膘	esf
朶	esu
采	esu
腰	esv
膝	esw
胀	eta
胜	etg
胙	eth
腹	etj
胳	etk
乃	etn
彡	ett
胼	eua
腾	eud
胖	euf
䏠	eug
臆	euj
脱	euk
膀	eup
胶	euq
腿	eve
妥	evf
舀	evf
肗	evg
肍	evn
腴	evw
胗	ewe
脍	ewf
脸	ewg
脞	eww
奚	exd
脂	exj
脑	eyb
脏	eyf
及	eyi
豖	eyi
脐	eyj
膻	eyl
肮	eym
肪	eyn
臁	eyu
腑	eyw
臃	eyx
堪	fad
霰	fae
卋	faf
霸	faf
卉	faj
哉	fak
载	fal
贲	fam
堞	fan
栽	fas
截	faw
裁	fay
邗	fbh
壭	fbj
凷	fbk
地	fbn
却	fcb
动	fcl
翅	fcn
运	fcp
魂	fcr
埃	fct
云	fcu
去	fcu
支	fcu
雼	fdf
震	fdf
坧	fdg
埯	fdj
坜	fdl
需	fdm
城	fdn
塬	fdr
垅	fdx
堋	fee
埒	fef
圾	fey
坛	ffc
亖	fff
圭	fff
填	ffh
款	ffi
圬	ffn
堵	fft
寺	ffu
垤	fgc
博	fge
圩	fgf
二	fgg
十	fgh
坏	fgi
埂	fgj
塥	fgk
垭	fgo
坪	fgu
越	fha
趣	fhb
坡	fhc
趄	fhe
㱏	fhf
直	fhf
圵	fhg
址	fhg
赴	fhh
趟	fhi
亍	fhk
盐	fhl
起	fhn
赵	fhq
趱	fht
走	fhu
超	fhv
真	fhw
圤	fhy
霄	fie
霈	fig
未	fii
嫠	fit
示	fiu
墚	fiv
求	fiy
戟	fja
朝	fje
埋	fjf
坦	fjg
刊	fjh
刌	fjh
亓	fjj
龺	fjj
井	fjk
墁	fjl
塌	fjn
进	fjp
埸	fjq
乾	fjt
翰	fjw
颉	fkd
袁	fke
吉	fkf
埕	fkg
圳	fkh
酃	fkk
埚	fkm
喜	fku
㿻	flf
雷	flf
㔹	fln
㘦	fln
协	flw
塄	fly
垌	fmg
圸	fmh
击	fmk
垲	fmn
垛	fms
南	fmu
坝	fmy
垻	fmy
㐊	fnb
㐋	fnb
䨒	fnf
韦	fnh
墀	fni
霹	fnk
馨	fnm
圠	fnn
圮	fnn
圯	fnn
声	fnr
忈	fnu
志	fnu
亏	fnv
亐	fnv
块	fnw
坭	fnx
专	fny
郝	fob
赫	fof
赦	fot
㶣	fou
灻	fou
赤	fou
勃	fpb
垸	fpf
壹	fpg
过	fpi
辻	fpk
迀	fpk
毂	fpl
壳	fpm
壶	fpo
索	fpx
坻	fqa
元	fqb
圥	fqb
顽	fqd
堍	fqk
雹	fqn
远	fqp
均	fqu
无	fqv
坎	fqw
坂	frc
垢	frg
圻	frh
埤	frt
坼	fry
堙	fsf
圢	fsh
霜	fsh
坷	fsk
霖	fss
雬	fsu
孝	ftb
才	fte
耂	fte
霆	ftf
考	ftg
埏	fth
者	ftj
雾	ftl
垧	ftm
圪	ftn
老	ftx
坆	fty
攼	fty
丧	fue
幸	fuf
雴	fuf
垃	fug
垶	fuh
境	fuj
培	fuk
增	ful
墒	fum
霎	fuv
垠	fve
雪	fvf
埭	fvi
埽	fvp
霓	fvq
替	fwf
夫	fwi
规	fwm
埠	fwn
赍	fww
堆	fwy
坶	fxg
坳	fxl
墩	fyb
雱	fyb
霅	fyf
圡	fyi
霁	fyj
壤	fyk
坑	fym
坊	fyn
壕	fyp
圹	fyt
雯	fyu
塘	fyv
坟	fyy
邢	gab
琪	gad
形	gae
玒	gag
武	gah
弄	gaj
开	gak
瑛	gam
珙	gaw
㺭	gbg
珥	gbg
屯	gbn
至	gcf
玛	gcg
丟	gcu
㺨	gcy
瑪	gcy
瑚	gde
天	gdi
蚕	gdj
吞	gdk
顼	gdm
忝	gdn
琦	gds
㺯	gdu
珑	gdx
㺴	gdy
青	gef
玥	geg
甫	geh
靓	gem
靛	gep
静	geq
瑶	ger
表	geu
琢	gey
珐	gfc
玕	gfh
球	gfi
于	gfk
盂	gfl
玮	gfn
迂	gfp
玩	gfq
琶	ggc
王	ggg
玨	ggg
五	ggh
环	ggi
一	ggl
瑟	ggn
琴	ggw
琵	ggx
珏	ggy
琥	gha
玻	ghc
㠪	ghd
正	ghd
㺺	ghg
焉	ghg
下	ghi
丅	ghk
玷	ghk
丐	ghn
璨	ghq
政	ght
甭	gie
歪	gig
不	gii
否	gik
琐	gim
还	gip
珧	giq
孬	giv
理	gjf
亘	gjg
㺫	gjh
刬	gjh
惠	gjh
丌	gjk
更	gjq
琨	gjx
吾	gkf
囊	gkh
玔	gkh
束	gki
卅	gkk
副	gkl
融	gkm
带	gkp
吏	gkq
豆	gku
事	gkv
画	glb
盏	glf
玾	glh
柬	gli
卌	glk
珈	glk
玏	gln
琏	glp
曹	gma
瑞	gmd
再	gmf
刺	gmi
丗	gmk
珊	gmm
玑	gmn
现	gmq
責	gmu
责	gmu
丙	gmw
丽	gmy
珼	gmy
珉	gna
㐏	gnb
琚	gnd
与	gng
珝	gng
瑕	gnh
㝳	gni
玌	gnn
玘	gnn
戸	gnr
忢	gnu
丂	gnv
瓦	gny
严	god
亚	gog
来	goi
灭	goi
赉	gom
琰	goo
辷	gpd
迋	gpd
琮	gpf
珲	gpl
琬	gpq
琛	gpw
殛	gqb
殆	gqc
殂	gqe
殖	gqf
残	gqg
琻	gqg
歹	gqi
列	gqj
殒	gqk
殃	gqm
殡	gqp
殉	gqq
殊	gqr
歼	gqt
殚	gqu
兀	gqv
兀	gqv
殓	gqw
死	gqx
玖	gqy
碧	grd
珀	grg
珠	gri
瑰	grq
玎	gsh
末	gsi
珂	gsk
琳	gss
珩	gtf
珞	gtk
璁	gtl
麦	gtu
玫	gty
平	guh
璋	guj
夹	guw
妻	gvh
瑙	gvt
玳	gwa
珍	gwe
瑜	gwg
兲	gwu
玢	gwv
玐	gwy
玲	gwy
纛	gxf
互	gxg
素	gxi
夷	gxw
璃	gyb
琉	gyc
斑	gyg
琂	gyg
玉	gyi
玊	gyi
班	gyt
琅	gyv
玟	gyy
虐	haa
遽	hae
眶	hag
虞	hak
瞄	hal
虎	ham
虑	han
虚	hao
眍	haq
虍	hav
虔	hay
眲	hbg
齒	hbj
颇	hcd
皮	hci
眙	hck
眸	hcr
攴	hcu
睃	hcw
睚	hdf
䀦	hdg
狊	hdu
肯	hef
眀	heg
瞬	hep
睬	hes
䀐	het
歧	hfc
眭	hff
盰	hfh
睹	hft
睦	hfw
盹	hgb
丄	hgd
睛	hge
盱	hgf
眄	hgh
凸	hgm
睐	hgo
睫	hgv
䀠	hhg
上	hhg
止	hhh
丨	hhl
卡	hhu
歨	hhu
矍	hhw
眦	hhx
卜	hhy
叔	hic
频	hid
瞠	hip
眺	hiq
步	hir
眇	hit
尗	hiu
㫖	hjf
旧	hjg
卓	hjj
桌	hjs
战	hka
占	hkf
觇	hkm
乩	hkn
点	hko
盀	hlf
卣	hln
卤	hlq
貞	hmu
贞	hmu
凣	hmv
眠	hna
瞰	hnb
鼎	hnd
卢	hne
鸬	hnq
瞩	hnt
忐	hnu
瞵	hoq
眯	hoy
㢟	hpd
瞎	hpd
壑	hpg
瞑	hpj
眈	hpq
見	hqb
餐	hqc
瞻	hqd
眵	hqq
㱑	hqu
歺	hqu
睁	hqv
盺	hrh
睥	hrt
瞟	hsf
盯	hsh
睡	htg
瞅	hto
眨	htp
瞳	huj
眼	hve
瞍	hvh
睨	hvq
齿	hwb
瞪	hwg
仧	hwu
具	hwu
盼	hwv
瞧	hwy
砦	hxd
些	hxf
赀	hxm
此	hxn
觜	hxq
柴	hxs
雌	hxw
紫	hxx
訾	hxy
眆	hyn
眩	hyx
盿	hyy
湛	iad
泔	iaf
江	iag
漠	iaj
灌	iak
潢	iam
㲺	ian
汇	ian
涝	iap
沤	iaq
柒	ias
㳀	iat
浇	iat
沏	iav
洪	iaw
滠	ibc
汓	ibg
洱	ibg
涵	ibi
凼	ibk
泐	ibl
氾	ibn
池	ibn
滁	ibw
泾	ica
渗	icd
涌	ice
泽	icf
治	ick
滩	icw
汉	icy
溤	icy
湖	ide
沯	idf
涯	idf
沰	idg
沽	idg
沣	idh
尜	idi
淹	idj
沥	idl
湎	idm
源	idr
涛	idt
尖	idu
溱	idw
泷	idx
汏	idy
汰	idy
汱	idy
浮	ieb
淝	iec
肖	ief
㳉	ieg
沮	ieg
削	iej
逍	iep
淫	iet
滔	iev
溪	iex
汲	iey
灞	ifa
法	ifc
濡	ifd
坔	iff
尘	iff
汢	ifg
汁	ifh
汗	ifh
潮	ifj
洁	ifk
污	ifn
渤	ifp
沅	ifq
渚	ift
潜	ifw
沌	igb
添	igd
清	ige
汪	igg
沔	igh
洹	igj
滞	igk
渍	igm
涞	igo
洌	igq
沫	igs
浅	igt
浃	igu
滤	iha
波	ihc
沚	ihg
泪	ihg
涉	ihi
淖	ihj
沾	ihk
浈	ihm
泸	ihn
瀣	ihq
小	iht
濉	ihw
消	iie
水	iii
淌	iim
洮	iiq
沙	iit
沝	iiy
瀑	ija
沓	ijf
汨	ijg
汩	ijg
温	ijl
溻	ijn
湿	ijo
渴	ijq
滥	ijt
混	ijx
浊	ijy
涓	ike
呇	ikf
汌	ikh
溃	ikh
渑	ikj
澡	ikk
涡	ikm
涸	ild
渭	ile
泴	ilf
涠	ilf
畄	ilf
畓	ilf
㳑	ilg
沺	ilg
泗	ilg
㳌	ilh
洄	ilk
氻	iln
涟	ilp
渐	ilr
泅	ilw
漯	ilx
澧	ima
没	imc
湍	imd
滑	ime
油	img
汕	imh
测	imj
沿	imk
㲹	imn
涔	imw
浿	imy
泯	ina
澉	inb
汛	inf
渥	ing
湄	inh
涮	inm
㲸	inn
汜	inn
汤	inr
泌	int
濯	inw
泥	inx
沁	iny
瀵	iol
淡	ioo
洣	ioy
黉	ipa
学	ipb
龸	ipb
浓	ipe
尝	ipf
演	ipg
泶	ipi
渖	ipj
党	ipk
浑	ipl
沉	ipm
涫	ipn
沈	ipq
滨	ipr
泞	ips
喾	ipt
滓	ipu
深	ipw
沱	ipx
光	iqb
沟	iqc
淆	iqd
鼗	iqf
淦	iqg
泺	iqi
洵	iqj
浼	iqk
涣	iqm
泡	iqn
逃	iqp
淘	iqr
泖	iqt
兆	iqv
㲼	iqy
汐	iqy
湃	ird
派	ire
泊	irg
沂	irh
洙	iri
汽	irn
浙	irr
激	iry
漂	isf
洒	isg
汀	ish
潭	isj
河	isk
淅	isr
淋	iss
漆	isw
沐	isy
洚	ita
沲	itb
活	itd
洗	itf
省	ith
潲	iti
洛	itk
劣	itl
澳	itm
汔	itn
渊	ito
泛	itp
少	itr
涤	its
滗	itt
海	itx
㳊	ity
汷	ity
溯	iub
滚	iuc
洋	iud
湔	iue
泮	iuf
泣	iug
㳯	iuh
漳	iuj
涪	iuk
滴	ium
滂	iup
溢	iuw
滋	iux
溉	ivc
㳫	ivf
当	ivf
汝	ivg
溲	ivh
渌	ivi
沼	ivk
淄	ivl
氿	ivn
浸	ivp
染	ivs
梁	ivw
涩	ivy
沧	iwb
脊	iwe
举	iwf
洽	iwg
濮	iwo
滏	iwq
涂	iwt
兴	iwu
氼	iwu
汾	iwv
浴	iww
沦	iwx
汃	iwy
汄	iwy
淮	iwy
泓	ixc
澠	ixg
沸	ixj
涨	ixt
溺	ixu
潍	ixw
渡	iya
淳	iyb
流	iyc
注	iyg
汴	iyh
济	iyj
沩	iyl
沆	iym
汸	iyn
沪	iyn
湾	iyo
濠	iyp
㲿	iyt
洲	iyt
尐	iyu
濂	iyu
浪	iyv
液	iyw
泫	iyx
汶	iyy
蜞	jad
蚶	jaf
虹	jag
蚜	jah
㫒	jaj
蜡	jaj
蜮	jak
蠛	jal
蟥	jam
蝶	jan
蠓	jap
晓	jat
暴	jaw
最	jbc
㫗	jbf
虸	jbg
蜢	jbl
虵	jbn
肾	jce
坚	jcf
蚂	jcg
贤	jcm
蚆	jcn
蛑	jcr
竖	jcu
紧	jcx
螞	jcy
蛎	jdd
蝴	jde
晨	jdf
䖨	jdg
蛄	jdg
蚌	jdh
晟	jdn
螈	jdr
旲	jdu
昃	jdw
蜉	jeb
冐	jef
暖	jef
明	jeg
蚏	jeg
盟	jel
暧	jep
䖶	jey
野	jfc
里	jfd
圼	jff
蛙	jff
旪	jfh
旰	jfh
虷	jfh
昧	jfi
旱	jfj
蝻	jfm
暑	jft
蚨	jfw
䖞	jfy
时	jfy
蛭	jgc
昊	jgd
晴	jge
旦	jgf
旺	jgg
蚟	jgg
是	jgh
量	jgj
晤	jgk
师	jgm
蛱	jgu
㫔	jhf
冒	jhf
刂	jhh
曱	jhk
申	jhk
甴	jhk
勖	jhl
早	jhn
虲	jhy
蛸	jie
螳	jip
晃	jiq
曝	jja
昌	jjf
昍	jjg
蚎	jjg
蛳	jjg
晶	jjj
蝎	jjq
蜾	jjs
䖵	jjy
蜈	jkg
蝇	jkj
蜗	jkm
曼	jlc
昷	jlf
蛊	jlf
蝈	jlg
䖬	jlh
蛼	jlh
蛔	jlk
㫑	jln
螺	jlx
蛐	jma
映	jmd
蚺	jmf
蚰	jmg
帅	jmh
旵	jmj
虮	jmn
蚬	jmq
蚋	jmw
蛽	jmy
蛡	jng
暇	jnh
虬	jnn
遢	jnp
电	jnv
曜	jnw
昵	jnx
显	jog
㫧	jou
炅	jou
蝼	jov
炚	joy
暄	jpg
螟	jpj
晕	jpl
蜿	jpq
晏	jpv
蛇	jpx
昂	jqb
蟾	jqd
蟓	jqj
晚	jqk
易	jqr
昴	jqt
昀	jqu
歇	jqw
蝗	jrg
昕	jrh
蚚	jrh
蛛	jri
蜱	jrt
颗	jsd
螵	jsf
晒	jsg
虰	jsh
果	jsi
蚵	jsk
夥	jsq
晰	jsr
杲	jsu
蚞	jsy
蜂	jtd
蚝	jtf
星	jtg
昨	jth
蜊	jtj
晌	jtm
虼	jtn
蟋	jto
蛾	jtr
蝌	jtu
晦	jtx
临	jty
蛘	jud
昱	juf
曦	jug
暗	juj
蜕	juk
螃	jup
蛟	juq
蝤	jus
昗	juu
旯	jvb
妟	jvf
归	jvg
螋	jvh
昭	jvk
旫	jvn
虭	jvn
蚣	jwc
蛤	jwg
㬰	jwi
蚧	jwj
蜍	jwt
晔	jwx
暹	jwy
㫐	jxb
曳	jxe
蠅	jxg
蚓	jxh
蚴	jxl
昆	jxx
昘	jyb
暾	jyb
蛀	jyg
景	jyi
蛴	jyj
曩	jyk
昉	jyn
虻	jyn
蚄	jyn
蚁	jyq
旷	jyt
旻	jyu
蠊	jyu
螂	jyv
蟀	jyx
旼	jyy
蚊	jyy
嘶	kad
嘞	kaf
叿	kag
哐	kag
呀	kah
噶	kaj
喵	kal
咂	kam
呓	kan
唠	kap
哎	kaq
哓	kat
哄	kaw
嚆	kay
嗫	kbc
咠	kbf
吇	kbg
咡	kbg
叩	kbh
咄	kbm
吔	kbn
吼	kbn
啊	kbs
邑	kcb
嗓	kcc
嗵	kce
吗	kcg
吧	kcn
吮	kcq
哞	kcr
唉	kct
唆	kcw
叹	kcy
嗎	kcy
呃	kdb
喹	kdf
咕	kdg
嘎	kdh
啡	kdj
呖	kdl
顺	kdm
咴	kdo
哒	kdp
㕦	kdu
噘	kdu
唪	kdw
咙	kdx
吠	kdy
肙	kef
咀	keg
嚼	kel
嗳	kep
鹃	keq
吸	key
喷	kfa
吱	kfc
嚅	kfd
哇	kff
吐	kfg
叶	kfh
味	kfi
嘲	kfj
嘻	kfk
鄙	kfl
喃	kfm
哧	kfo
噎	kfp
呒	kfq
哮	kft
呋	kfw
吋	kfy
吨	kgb
吴	kgd
哺	kge
呈	kgf
㕵	kgg
㕶	kgg
吓	kgh
呸	kgi
哽	kgj
喇	kgk
啧	kgm
号	kgn
哑	kgo
逞	kgp
咧	kgq
唛	kgt
咦	kgx
距	kha
蹑	khb
踊	khc
跨	khd
啃	khe
趺	khf
践	khg
趾	khh
跳	khi
踢	khj
中	khk
盅	khl
跺	khm
忠	khn
蹼	kho
踪	khp
跑	khq
跌	khr
路	kht
足	khu
跟	khv
趴	khw
嘴	khx
卟	khy
哨	kie
啵	kih
唢	kim
咣	kiq
吵	kit
嘬	kjb
哩	kjf
呻	kjh
唱	kjj
喁	kjm
黾	kjn
喝	kjq
虽	kju
骂	kkc
器	kkd
吕	kkf
吅	kkg
串	kkh
品	kkk
鼍	kkl
咒	kkm
另	klb
咽	kld
喟	kle
嘿	klf
呬	klg
喂	klg
呷	klh
唓	klh
别	klj
咖	klk
叻	kln
嗣	kma
郧	kmb
喘	kmd
嘣	kme
啁	kmf
吊	kmh
勋	kml
嘤	kmm
叽	kmn
哕	kmq
哚	kms
员	kmu
員	kmu
呐	kmw
呗	kmy
唄	kmy
叼	kng
叫	knh
噼	knk
唰	knm
㕧	knt
嘱	knt
呢	knx
吣	kny
噗	kog
啖	koo
喽	kov
吙	koy
咪	koy
哝	kpe
噻	kpf
喧	kpg
嘧	kpn
咛	kps
喀	kpt
嚓	kpw
兄	kqb
唏	kqd
唫	kqg
噜	kqg
史	kqi
唤	kqm
咆	kqn
哆	kqq
吻	kqr
吹	kqw
鸣	kqy
唣	kra
呱	krc
嗥	krd
哌	kre
㕷	krg
听	krh
啪	krr
啤	krt
啦	kru
嘌	ksf
哂	ksg
叮	ksh
喳	ksj
呵	ksk
啉	kss
呆	ksu
㕲	ksy
噬	kta
唾	ktg
咱	kth
咯	ktk
响	ktm
吃	ktn
啾	kto
哦	ktr
呼	ktu
呚	kty
咊	kty
嗍	kub
咩	kud
㕸	kug
㖕	kuh
吖	kuh
喑	kuj
噌	kul
嘀	kum
啼	kup
咬	kuq
唼	kuv
嗌	kuw
叧	kvb
呶	kvc
哏	kve
哪	kvf
嗖	kvh
啸	kvi
㕤	kvn
叨	kvn
呛	kwb
嗡	kwc
咐	kwf
哈	kwg
喉	kwn
嗲	kwq
咻	kws
只	kwu
吩	kwv
唑	kww
哗	kwx
㕥	kwy
叭	kwy
喙	kxe
吲	kxh
呦	kxl
叱	kxn
哟	kxq
吡	kxx
吆	kxy
哼	kyb
唷	kyc
唁	kyg
哜	kyj
嚷	kyk
吭	kym
㕫	kyn
咏	kyn
嚎	kyp
嘛	kys
嗾	kyt
啷	kyv
啐	kyw
呅	kyy
轼	laa
羁	laf
㘟	lak
囝	lbd
辄	lbn
轻	lca
轰	lcc
㘝	lci
囜	lci
罵	lcu
轭	ldb
固	ldd
囿	lde
罟	ldf
軲	ldg
轱	ldg
因	ldi
罪	ldj
恩	ldn
畸	lds
畴	ldt
辏	ldw
畎	ldy
軑	ldy
轪	ldy
胃	lef
䢁	leg
圂	lei
罢	lfc
畦	lff
軒	lfh
轩	lfh
団	lfi
䍐	lfj
辕	lfk
罱	lfm
转	lfn
黑	lfo
园	lfq
团	lft
圉	lfu
囤	lgb
轾	lgc
囯	lgd
畏	lge
軖	lgg
罡	lgh
罘	lgi
畀	lgj
辐	lgk
辆	lgm
车	lgn
国	lgy
罩	lhj
㐃	lhk
皿	lhn
囦	lii
眔	liu
軣	liu
辊	ljx
辑	lkb
驾	lkc
回	lkd
加	lkg
䡅	lkh
甽	lkh
贺	lkm
迦	lkp
架	lks
轵	lkw
袈	lky
男	llb
畕	llf
䡒	llg
圜	llg
䡛	llh
㘡	llk
田	lll
㽖	lln
䡃	lln
㘞	llv
嬲	llv
軸	lmg
轴	lmg
軕	lmh
䡄	lmn
買	lmu
辋	lmu
辗	lna
囙	lnd
翈	lng
劜	lnn
軋	lnn
轧	lnn
思	lnu
罹	lnw
辚	loq
䍘	lou
连	lpk
連	lpk
畹	lpq
边	lpv
轹	lqi
蜀	lqj
逻	lqp
囫	lqr
罗	lqu
软	lqw
鸭	lqy
畈	lrc
堑	lrf
斩	lrh
斬	lrh
暂	lrj
錾	lrq
椠	lrs
轶	lrw
町	lsh
困	lsi
甼	lsj
轲	lsk
䍒	lsu
轿	ltd
囷	lti
略	ltk
力	ltn
图	ltu
畋	lty
圈	lud
畔	luf
䢂	lug
疃	luj
罾	lul
较	luq
囡	lvd
㚻	lvf
婁	lvf
轺	lvk
辎	lvl
軌	lvn
轨	lvn
轫	lvy
轸	lwe
输	lwg
办	lwi
囚	lwi
界	lwj
轮	lwx
㽗	lwy
囹	lwy
累	lxi
毗	lxx
辙	lyc
圁	lyd
詈	lyf
罚	lyj
辘	lyn
曲	mad
㞬	maf
嵌	maf
屸	mag
岈	mah
岽	mai
冊	mak
崂	map
岖	maq
戝	mat
典	maw
㕀	mbb
㞨	mbg
䢳	mbh
邖	mbh
邮	mbh
郥	mbh
貤	mbn
岜	mcb
峄	mcf
凤	mci
禸	mci
贻	mck
殳	mcu
峻	mcw
贿	mde
岩	mdf
岵	mdg
央	mdi
崦	mdj
盎	mdl
遄	mdm
炭	mdo
鸯	mdq
屵	mdr
崎	mds
㞧	meb
髓	med
崩	mee
冑	mef
胄	mef
骨	mef
岄	meg
髁	mej
髑	mel
骰	mem
屷	men
髅	meo
髂	mep
鹘	meq
骺	mer
骼	met
骱	mew
骸	mey
岐	mfc
冃	mfd
冄	mfd
冉	mfd
亗	mff
峙	mff
屽	mfh
巅	mfh
赇	mfi
周	mfk
赎	mfn
财	mft
赋	mga
赙	mge
同	mgk
屿	mgn
崃	mgo
夙	mgq
贱	mgt
峡	mgu
凪	mhd
帱	mhd
帏	mhf
幅	mhg
帖	mhh
帽	mhj
巾	mhk
帼	mhl
帆	mhm
冂	mhn
幞	mho
帕	mhr
帐	mht
幢	mhu
帷	mhw
峭	mie
汖	miu
嵴	miw
㞱	mjf
则	mjh
則	mjh
赐	mjq
岿	mjv
冋	mkd
迥	mkp
贶	mkq
屴	mlb
崮	mld
岬	mlh
崽	mln
崭	mlr
峀	mmf
岫	mmg
屾	mmh
岀	mmj
山	mmm
㞦	mmn
岗	mmq
罂	mmr
婴	mmv
賏	mmy
岷	mna
㐕	mnb
岂	mnb
嵋	mnh
剀	mnj
凯	mnm
乢	mnn
屺	mnn
囘	mnv
赆	mny
㶡	moi
赕	moo
嶙	moq
嵝	mov
廸	mpd
迪	mpd
崇	mpf
贮	mpg
䢙	mpi
辿	mpk
㞫	mpu
崆	mpw
见	mqb
购	mqc
赡	mqd
崟	mqf
崯	mqg
飓	mqh
冈	mqi
罓	mqi
风	mqi
刚	mqj
岣	mqk
飚	mqo
网	mqq
峁	mqt
岁	mqu
峥	mqv
贩	mrc
凰	mrg
岶	mrg
岓	mrh
嵬	mrq
凩	msi
剁	msj
岢	msk
朵	msu
崾	msv
崧	msw
账	mta
峰	mtd
赂	mtk
几	mtn
贬	mtp
峨	mtr
嵊	mtu
巍	mtv
敗	mty
败	mty
嵯	mud
岦	muf
峷	muj
嶂	muj
赔	muk
赠	mul
赚	muv
嵫	mux
罔	muy
屶	mvb
赊	mwf
嵛	mwg
内	mwi
㞤	mwu
肉	mww
崔	mwy
嶷	mxt
崞	myb
丹	myd
彤	mye
訔	myf
赃	myf
凡	myi
嵩	mym
赅	myn
㞵	myu
㞶	myy
展	nae
惬	nag
羾	nag
异	naj
羿	naj
懵	nal
屉	nan
怄	naq
懂	nat
民	nav
殿	naw
慌	nay
孱	nbb
慑	nbc
㞌	nbd
䣁	nbh
邔	nbh
屈	nbm
忚	nbn
屙	nbs
敢	nbt
惨	ncd
怪	ncf
㞋	nci
怡	nck
㞎	ncv
悛	ncw
惰	nda
居	ndd
怙	ndg
剧	ndj
怖	ndm
忧	ndn
恢	ndo
忕	ndy
愤	nfa
层	nfc
丑	nfd
恃	nff
忓	nfh
慎	nfh
屚	nfi
慰	nfi
卂	nfk
迅	nfp
怃	nfq
屠	nft
导	nfu
忖	nfy
屋	ngc
刁	ngd
情	nge
䍿	ngf
忹	ngg
怔	ngh
怀	ngi
恒	ngj
司	ngk
怦	ngu
愫	ngx
眉	nhd
胥	nhe
遐	nhf
疋	nhi
蛋	nhj
丩	nhk
鹛	nhq
收	nht
惧	nhw
疏	nhy
悄	nie
尿	nii
氹	nii
惝	nim
恍	niq
犀	nir
悭	njc
悍	njf
怛	njg
慢	njl
惕	njq
惺	njt
憬	njy
悒	nkc
吢	nkf
忡	nkh
愕	nkk
辟	nku
翼	nla
乪	nld
屇	nld
怬	nlg
忇	nln
惭	nlr
悃	nls
愣	nly
届	nmd
惆	nmf
怞	nmg
恫	nmg
刷	nmh
屃	nmi
屓	nmi
㞯	nmj
恻	nmj
恺	nmn
惘	nmu
凥	nmv
巽	nna
忸	nnf
己	nng
书	nnh
局	nnk
乙	nnl
忆	nnn
忋	nnn
忌	nnu
乜	nnv
快	nnw
怩	nnx
㤈	nny
羽	nny
屎	noi
屡	nov
迉	npe
恽	npl
忱	npq
懈	nqe
惍	nqg
恂	nqj
惚	nqr
習	nrf
怕	nrg
忻	nrh
忾	nrn
愧	nrq
恓	nsg
忊	nsh
杘	nsi
憷	nss
怵	nsy
怅	nta
悸	ntb
发	ntc
恬	ntd
必	nte
尾	ntf
性	ntg
怍	nth
虱	ntj
属	ntk
恤	ntl
懊	ntm
愀	nto
履	ntt
悔	ntx
改	nty
攺	nty
屏	nua
㞐	nud
习	nud
翌	nuf
㥃	nug
翋	nug
飞	nui
惮	nuj
屖	nuk
悦	nuk
憎	nul
慊	nuv
悌	nux
悯	nuy
慨	nvc
恨	nve
妀	nvg
怊	nvk
忉	nvn
尻	nvv
怆	nwb
忪	nwc
戮	nwe
愉	nwg
乆	nwi
夬	nwi
惟	nwy
惯	nxf
憴	nxg
怫	nxj
尼	nxv
屁	nxx
恼	nyb
惦	nyh
㣺	nyi
乄	nyi
尺	nyi
昼	nyj
咫	nyk
懔	nyl
㤃	nyn
心	nyn
迟	nyp
尽	nyu
慷	nyv
以	nyw
忟	nyy
煤	oaf
䉺	oag
灴	oag
灷	oaj
炬	oan
烧	oat
烘	oaw
籽	obg
邩	obh
灺	obn
烃	oca
糅	ocb
糁	ocd
粑	ocn
粝	odd
糊	ode
䊀	odg
炻	odg
烦	odm
类	odu
粗	oeg
㶲	oeh
爝	oel
烼	oey
糯	ofd
灶	ofg
㶥	ofh
籵	ofh
炜	ofn
烤	oft
籿	ofy
邺	ogb
业	ogd
精	oge
粳	ogj
焐	ogk
炳	ogm
凿	ogu
焯	ohj
粘	ohk
炒	oit
爆	oja
焊	ojf
灲	ojh
熳	ojl
煜	oju
烛	ojy
燥	okk
炽	okw
烟	old
畨	olf
煨	olg
畑	olg
炠	olh
粙	omg
灿	omh
籼	omh
炯	omk
籶	omn
㐘	onb
糈	onh
断	onr
炔	onw
烬	ony
郯	oob
剡	ooj
火	ooo
炎	oou
炏	ooy
烷	opf
煊	opg
迷	opi
熔	opw
遴	oqa
灮	oqb
烯	oqd
烁	oqi
焕	oqm
炮	oqn
焰	oqv
炊	oqw
㶤	oqy
灼	oqy
粕	org
䉼	orh
炘	orh
粞	osg
灯	osh
炑	osy
烽	otd
糙	otf
炸	oth
烙	otk
燠	otm
燔	oto
烀	otu
敉	oty
炇	oty
秌	oty
烊	oud
燧	oue
料	ouf
粒	oug
焙	ouk
熵	oum
焖	oun
糍	oux
㶢	ovb
煺	ove
娄	ovf
籹	ovg
灱	ovn
数	ovt
炝	owb
煅	owd
烩	owf
糇	own
粉	owv
烨	owx
焓	owy
糨	oxk
炷	oyg
炕	oym
炉	oyn
燮	oyo
米	oyt
粮	oyv
粹	oyw
炫	oyx
灬	oyy
炆	oyy
宦	pah
寞	paj
宽	pam
字	pbf
㝋	pbj
㝊	pcu
宏	pdc
寡	pde
㝒	pdf
宕	pdf
害	pdh
寄	pds
宊	pdu
寮	pdu
宠	pdx
肎	pef
宜	peg
农	pei
家	peu
冢	pey
宗	pfi
寒	pfj
完	pfq
守	pfu
室	pgc
㝉	pgf
宇	pgf
定	pgh
宣	pgj
富	pgk
寅	pgm
写	pgn
宝	pgy
寂	phi
㓀	phu
宵	pie
㲾	piu
幂	pjd
审	pjh
寓	pjm
冥	pju
宴	pjv
宫	pkk
郓	plb
寰	plg
皲	plh
军	plj
軍	plj
冗	pmb
宂	pmb
宙	pmf
冚	pmj
甯	pne
官	pnh
密	pnt
寥	pnw
廴	pny
冞	pou
宩	pou
灾	pou
之	ppp
㝎	ppu
宛	pqb
㓁	pqb
冤	pqk
鸩	pqq
冘	pqv
宾	prg
牢	prh
宁	psj
宋	psu
宅	pta
宪	ptf
客	ptk
褡	pua
衩	puc
实	pud
衫	pue
衬	puf
袜	pug
补	puh
衤	pui
宰	puj
裎	puk
裢	pul
袖	pum
袂	pun
褛	puo
袍	puq
裨	pur
襟	pus
袄	put
宍	puu
袢	puu
初	puv
裕	puw
襁	pux
裤	puy
宄	pvb
安	pvf
案	pvs
空	pwa
窿	pwb
突	pwd
罕	pwf
窒	pwg
窕	pwi
窠	pwj
窜	pwk
穷	pwl
帘	pwm
窟	pwn
窭	pwo
穸	pwq
窑	pwr
窗	pwt
㓁	pwu
穴	pwu
究	pwv
容	pww
穹	pwx
鹤	pwy
它	pxb
宆	pxb
祺	pya
㝑	pyb
祁	pyb
祷	pyd
祖	pye
㝘	pyf
社	pyf
福	pyg
祉	pyh
礻	pyi
神	pyj
祝	pyk
视	pym
冖	pyn
祢	pyq
祈	pyr
祚	pyt
祥	pyu
禄	pyv
宀	pyy
锘	qad
钳	qaf
釭	qag
舛	qah
错	qaj
钷	qak
锚	qal
钜	qan
铹	qap
鈛	qat
铙	qat
氏	qav
氐	qay
釴	qay
镊	qbc
釨	qbg
鉺	qbg
铒	qbg
卬	qbh
夘	qbh
邜	qbh
釕	qbh
钌	qbh
凶	qbk
锰	qbl
夗	qbn
怨	qbn
釶	qbn
迎	qbp
鸳	qbq
锕	qbs
色	qcb
铎	qcf
勾	qci
鈀	qcn
钯	qcn
鎷	qcy
钗	qcy
危	qdb
郄	qdc
肴	qde
锛	qdf
鈷	qdg
鉐	qdg
钴	qdg
锲	qdh
希	qdm
铖	qdn
然	qdo
厃	qdr
铸	qdt
镣	qdu
詹	qdw
釱	qdy
钛	qdy
锊	qef
鈅	qeg
钥	qeg
觥	qei
角	qej
觖	qen
釢	qen
觚	qer
釤	qet
钐	qet
斛	qeu
解	qev
勻	qfd
釷	qfg
钍	qfg
㚈	qfh
針	qfh
釬	qfh
针	qfh
镭	qfl
锗	qft
鲽	qga
印	qgb
鲐	qgc
鱿	qgd
铺	qge
鱼	qgf
鲆	qgg
钙	qgh
盥	qgi
鲁	qgj
匐	qgk
鳃	qgl
鲷	qgm
鲺	qgn
鳞	qgo
鲩	qgp
鲍	qgq
鳇	qgr
鳔	qgs
钱	qgt
鲜	qgu
鲟	qgv
鲋	qgw
鲸	qgy
铍	qhc
䀏	qhd
䤠	qhg
鉬	qhg
钼	qhg
亇	qhj
钻	qhk
外	qhy
釙	qhy
钋	qhy
销	qie
玺	qig
乐	qii
锁	qim
铴	qin
迩	qip
铫	qiq
钞	qit
尔	qiu
淾	qiu
铛	qiv
釥	qiy
郇	qjb
铿	qjc
旬	qjd
象	qje
锂	qjf
鈤	qjg
钽	qjg
刈	qjh
釗	qjh
钊	qjh
镘	qjl
龟	qjn
锡	qjq
锞	qjs
锟	qjx
鉵	qjy
句	qkd
名	qkf
釦	qkg
锃	qkg
釧	qkh
钏	qkh
铝	qkk
劬	qkl
锅	qkm
免	qkq
甸	qld
鈿	qlg
钿	qlg
鉀	qlh
钾	qlh
釛	qln
锶	qln
链	qlp
锣	qlq
镙	qlx
奂	qmd
鈾	qmg
铀	qmg
铡	qmj
铅	qmk
釠	qmn
铠	qmn
钢	qmq
負	qmu
负	qmu
钠	qmw
鋇	qmy
钡	qmy
饶	qna
饣	qnb
饴	qnc
锯	qnd
馁	qne
钮	qnf
䦀	qng
乌	qng
镅	qnh
蚀	qnj
馈	qnk
饥	qnm
釓	qnn
釔	qnn
釲	qnn
钆	qnn
钇	qnn
馆	qnp
饮	qnq
饭	qnr
馇	qns
饿	qnt
㣻	qnu
饼	qnu
包	qnv
馀	qnw
铌	qnx
鈊	qny
鬯	qob
镤	qog
匊	qoi
灳	qoi
锬	qoo
炙	qou
魚	qou
镂	qov
鈥	qoy
銤	qoy
钬	qoy
镓	qpe
锭	qpg
镔	qpr
铵	qpv
镩	qpw
铊	qpx
匈	qqb
钩	qqc
鍂	qqg
镥	qqg
匁	qqi
匇	qqi
铄	qqi
铭	qqk
钨	qqn
鑫	qqq
锪	qqr
铩	qqs
铆	qqt
多	qqu
爻	qqu
铮	qqv
钦	qqw
釸	qqy
钓	qqy
钣	qrc
勿	qre
鉑	qrg
铂	qrg
釿	qrh
铢	qri
刎	qrj
锦	qrm
忽	qrn
锨	qrq
铁	qrw
匆	qry
弑	qsa
镖	qsf
钵	qsg
釘	qsh
钉	qsh
刹	qsj
钶	qsk
杀	qsu
鈢	qsy
猎	qta
犯	qtb
狁	qtc
锋	qtd
犭	qte
钎	qtf
狂	qtg
镍	qth
独	qtj
铬	qtk
狎	qtl
猾	qtm
儿	qtn
勹	qtn
锹	qto
狞	qtp
狗	qtq
狐	qtr
猹	qts
猁	qtt
狡	qtu
狠	qtv
猴	qtw
狒	qtx
㐅	qty
乂	qty
狼	qty
鉌	qty
匀	qud
钭	quf
鉝	qug
鍆	qug
镁	qug
鋅	quh
锌	quh
镜	quj
锐	quk
镝	qum
钔	qun
镨	quo
镑	qup
铰	quq
铲	qut
镒	quw
锑	qux
邹	qvb
银	qve
刍	qvf
臽	qvf
釹	qvg
钕	qvg
争	qvh
铷	qvk
锱	qvl
急	qvn
釖	qvn
釚	qvn
锓	qvp
煞	qvt
勼	qvv
雏	qvw
锻	qwd
铨	qwg
勽	qwi
欠	qwu
锉	qww
铧	qwx
釟	qwy
锥	qwy
镄	qxj
镪	qxk
匂	qxv
锴	qxx
镀	qya
镦	qyb
铳	qyc
訇	qyd
铱	qye
䚻	qyf
久	qyi
勺	qyi
夊	qyi
镶	qyk
镐	qym
鈁	qyn
钫	qyn
灸	qyo
卵	qyt
镰	qyu
贸	qyv
铉	qyx
鈫	qyy
拭	raa
皂	rab
撕	rad
撒	rae
扛	rag
措	raj
描	ral
拒	ran
捞	rap
抠	raq
找	rat
拱	raw
揶	rbb
报	rbc
挕	rbg
㧄	rbh
邤	rbh
拯	rbi
拙	rbm
扡	rbn
拚	rca
抒	rcb
掇	rcc
掺	rcd
捅	rce
择	rcf
反	rci
抬	rck
把	rcn
皅	rcn
返	rcp
挨	rct
㿝	rcu
摊	rcw
払	rcy
瓜	rcy
扼	rdb
拔	rdc
振	rdf
翱	rdf
拓	rdg
排	rdj
颀	rdm
扰	rdn
挞	rdp
掎	rds
㚖	rdu
撩	rdu
捧	rdw
拢	rdx
㧋	rdy
援	ref
抈	reg
拥	reh
扔	ren
授	rep
摇	rer
技	rfc
持	rff
扗	rfg
扞	rfh
盾	rfh
擀	rfj
皁	rfj
拮	rfk
擂	rfl
质	rfm
抟	rfn
挝	rfp
抚	rfq
拷	rft
扶	rfw
邱	rgb
丘	rgd
捕	rge
皇	rgf
抂	rgg
扌	rgh
后	rgk
岳	rgm
遑	rgp
抹	rgs
乒	rgt
挟	rgu
捷	rgv
兵	rgw
乓	rgy
掳	rha
卸	rhb
披	rhc
看	rhf
扯	rhg
攫	rhh
掉	rhj
牛	rhk
扑	rhy
邾	rib
捎	rie
朱	rii
撑	rip
挑	riq
抄	rit
泉	riu
挡	riv
撮	rjb
捍	rjf
抇	rjg
担	rjg
抻	rjh
揭	rjq
揽	rjt
拽	rjx
揖	rkb
挹	rkc
捐	rke
扣	rkg
捉	rkh
操	rkk
拐	rkl
损	rkm
摁	rld
摆	rlf
畠	rlf
舞	rlg
押	rlh
捙	rlh
劤	rln
劧	rln
劰	rln
扐	rln
捆	rls
撂	rlt
摞	rlx
缸	rma
投	rmc
揣	rmd
抽	rmg
帛	rmh
缶	rmk
撄	rmm
缺	rmn
摧	rmw
抿	rna
气	rnb
氢	rnc
戶	rnd
据	rnd
氖	rne
扭	rnf
䎅	rng
挧	rng
握	rng
氘	rnj
擗	rnk
氤	rnl
氙	rnm
扎	rnn
癿	rnn
氮	rno
氨	rnp
扬	rnr
拨	rnt
氧	rnu
氯	rnv
氛	rnw
氟	rnx
抋	rny
拟	rny
搂	rov
廹	rpd
迫	rpd
皖	rpf
揎	rpg
近	rpk
挥	rpl
摈	rpr
拧	rps
按	rpv
控	rpw
抵	rqa
抑	rqb
皃	rqb
鬼	rqc
捦	rqg
撸	rqg
拘	rqk
换	rqm
抱	rqn
掬	rqo
揿	rqq
掏	rqr
掐	rqv
欣	rqw
的	rqy
扳	rrc
㿟	rrg
拍	rrg
折	rrh
抙	rrh
斦	rrh
蜇	rrj
哲	rrk
逝	rrp
掀	rrq
白	rrr
捭	rrt
拆	rry
拪	rsg
打	rsh
揸	rsj
托	rta
拖	rtb
括	rtd
搬	rte
插	rtf
手	rtg
擤	rth
揪	rto
斤	rtt
敀	rty
拼	rua
搠	rub
搓	rud
拦	ruf
拉	rug
捫	rug
撞	ruj
掊	ruk
摘	rum
扪	run
皎	ruq
撙	rus
搁	rut
接	ruv
挪	rvf
㧮	rvg
扫	rvg
搜	rvh
招	rvk
抛	rvl
㧅	rvn
扏	rvn
殷	rvn
拶	rvq
捃	rvt
执	rvy
抢	rwb
拊	rwf
拴	rwg
失	rwi
迭	rwp
㒵	rwu
扮	rwv
挫	rww
抡	rwx
扒	rwy
皀	rxb
掾	rxe
掼	rxf
拇	rxg
指	rxj
拗	rxl
㧈	rxn
搦	rxu
批	rxx
摭	rya
撤	ryc
拄	ryg
掂	ryh
斥	ryi
挤	ryj
攘	ryk
擅	ryl
搞	rym
㧍	ryn
护	ryn
扩	ryt
搪	ryv
掖	ryw
摔	ryx
抆	ryy
械	saa
栉	sab
棋	sad
杢	saf
柑	saf
杠	sag
栋	sai
模	saj
槿	sak
横	sam
柜	san
檬	sap
枢	saq
桡	sat
杙	say
椰	sbb
椭	sbd
李	sbf
杍	sbg
栮	sbg
䢶	sbh
邒	sbh
杝	sbn
杼	scb
桶	sce
树	scf
杩	scg
杷	scn
梭	scw
权	scy
榪	scy
㭅	sdg
枯	sdg
柘	sdg
楔	sdh
枥	sdl
顶	sdm
椅	sds
梆	sdt
䙲	sdu
橛	sdu
棒	sdw
栊	sdx
杕	sdy
杖	sdy
枤	sdy
桴	seb
楹	sec
棚	see
枂	seg
㭁	sen
杉	set
㭬	sey
极	sey
鄄	sfb
枝	sfc
垔	sff
桂	sff
杜	sfg
杆	sfh
标	sfi
桔	sfk
檑	sfl
楠	sfm
椟	sfn
材	sft
樯	sfu
棱	sfw
村	sfy
醋	sga
酏	sgb
酸	sgc
本	sgd
酉	sgd
酹	sge
酝	sgf
枉	sgg
丁	sgh
杯	sgi
醒	sgj
梧	sgk
楝	sgl
柄	sgm
配	sgn
醚	sgo
酡	sgp
酌	sgq
酊	sgs
栈	sgt
枰	sgu
酚	sgw
酯	sgx
醉	sgy
杫	shg
相	shg
椒	shi
棹	shj
桢	shm
想	shn
朴	shy
梢	sie
桫	sii
樘	sip
桃	siq
杪	sit
档	siv
榉	siw
㭂	siy
杳	sjf
查	sjg
覃	sjj
榻	sjn
棵	sjs
槛	sjt
棍	sjx
楫	skb
可	skd
杏	skf
枵	skg
杊	skh
榀	skk
哥	sks
枳	skw
㭗	slf
柶	slg
柙	slh
枷	slk
朸	sln
椤	slq
楞	sly
柚	smg
杣	smh
栅	smm
机	smn
枫	smq
賈	smu
贾	smu
枘	smw
梖	smy
㐉	snb
朰	snb
橄	snb
椐	snd
栩	sng
楣	snh
榍	sni
札	snn
杞	snn
杨	snr
杺	sny
䙳	sou
杰	sou
粟	sou
楼	sov
廼	spd
迺	spd
棕	spf
楦	spg
棺	spn
枕	spq
槟	spr
柠	sps
桉	spv
榨	spw
柁	spx
柢	sqa
构	sqc
桅	sqd
桷	sqe
橹	sqg
栎	sqi
橡	sqj
枸	sqk
攀	sqq
柳	sqt
榴	sqy
板	src
槔	srd
柏	srg
杽	srh
析	srh
株	sri
棉	srm
槐	srq
皙	srr
檄	sry
郴	ssb
彬	sse
禁	ssf
栖	ssg
朾	ssh
楂	ssj
柯	ssk
梵	ssm
楚	ssn
焚	sso
梦	ssq
森	sss
栗	ssu
婪	ssv
棼	ssw
林	ssy
枨	sta
桥	std
橇	stf
棰	stg
柞	sth
格	stk
榭	stm
楸	sto
覆	stt
䅇	stu
梅	stx
枚	sty
柇	sty
样	sud
栏	suf
柆	sug
椚	sug
梓	suh
樟	suj
榈	suk
榜	sup
校	suq
榇	sus
梯	sux
概	svc
根	sve
要	svf
桕	svg
棣	svi
朷	svn
朹	svn
棂	svo
枪	swb
松	swc
椴	swd
桧	swf
栓	swg
槌	swn
枞	sww
桦	swx
朲	swy
朳	swy
椎	swy
椽	sxe
朼	sxn
杛	sxn
楷	sxx
㭃	sxy
椁	syb
梳	syc
桩	syf
柱	syg
术	syi
榱	syk
檀	syl
杭	sym
枋	syn
述	syp
榔	syv
筇	tab
箕	tad
笁	taf
筐	tag
逄	tah
升	tak
筑	tam
簪	taq
䇝	tar
乇	tav
筮	taw
䄩	tay
长	tay
㐌	tbb
竾	tbb
䇯	tbf
季	tbf
秄	tbg
䄦	tbh
䄬	tbn
彵	tbn
迤	tbp
径	tca
笆	tcb
笃	tcf
笞	tck
么	tcu
篤	tcu
私	tcy
矩	tda
舌	tdd
䇢	tdf
䄷	tdg
短	tdg
秙	tdg
逢	tdh
夭	tdi
乔	tdj
知	tdk
岙	tdm
乱	tdn
适	tdp
鸹	tdq
敌	tdt
矢	tdu
矬	tdw
笼	tdx
㣕	tdy
舡	tea
秀	teb
䄴	teg
租	teg
舻	teh
舟	tei
甪	tek
舯	tek
盘	tel
般	tem
䄧	ten
艉	ten
透	tep
㣊	ter
舶	ter
舸	tes
艇	tet
艏	teu
稻	tev
舱	tew
舭	tex
航	tey
丢	tfc
壬	tfd
玍	tff
竺	tff
秆	tfh
午	tfj
竿	tfj
千	tfk
德	tfl
毛	tfn
迁	tfp
先	tfq
箸	tft
乖	tfu
垂	tga
生	tgd
箐	tge
竽	tgf
彺	tgg
征	tgh
重	tgj
衙	tgk
熏	tgl
策	tgm
徕	tgo
笺	tgr
秣	tgs
秤	tgu
秉	tgv
算	tha
彼	thc
自	thd
䇛	thf
乍	thf
䄳	thg
片	thg
徙	thh
处	thi
昝	thj
咎	thk
鼻	thl
息	thn
延	thp
臬	ths
稍	tie
衍	tif
簿	tig
乑	tii
徜	tim
箔	tir
秒	tit
尓	tiu
香	tjf
得	tjg
利	tjh
䖝	tji
犁	tjr
梨	tjs
复	tjt
㕿	tkf
各	tkf
和	tkg
种	tkh
稆	tkk
禹	tkm
积	tkw
务	tlb
竻	tlb
甶	tld
血	tld
备	tlf
盉	tlf
笽	tlf
箅	tlg
笚	tlj
徊	tlk
惫	tln
粤	tlo
笾	tlp
箩	tlq
衅	tlu
稷	tlw
秃	tmb
役	tmc
身	tmd
笛	tmf
㣙	tmg
微	tmg
秞	tmg
币	tmh
秈	tmh
㟀	tmj
屲	tmj
向	tmk
奥	tmo
秽	tmq
筫	tmu
凢	tmv
処	tmv
乞	tnb
笥	tng
䄫	tnn
筷	tnn
迄	tnp
秘	tnt
释	toc
釆	toi
番	tol
釉	tom
悉	ton
夈	tou
篓	tov
秋	toy
稼	tpe
乏	tpi
管	tpn
箢	tpq
箜	tpw
禿	tqb
稀	tqd
衔	tqf
称	tqi
徇	tqj
笱	tqk
移	tqq
笏	tqr
黎	tqt
稳	tqv
箍	tra
筢	trc
牜	trd
犄	trd
特	trf
䄸	trg
徨	trg
御	trh
穆	tri
筘	trk
我	trn
物	trq
牺	trs
牧	trt
犍	trv
秩	trw
牝	trx
徼	try
䇴	tsf
䄽	tsg
徆	tsg
笨	tsg
㣔	tsh
箱	tsh
簟	tsj
篥	tss
条	tsu
秫	tsy
笑	ttd
笔	ttf
竹	ttg
笮	tth
丿	ttl
夂	ttn
禾	ttt
秝	tty
徉	tud
箭	tue
笠	tuf
乎	tuh
简	tuj
税	tuk
乊	tur
冬	tuu
乘	tux
很	tve
委	tvf
笤	tvk
逶	tvp
魏	tvr
笋	tvt
筏	twa
符	twf
答	twg
筱	twh
黍	twi
篌	twn
徐	twt
秂	twu
稚	twy
龜	txd
篆	txe
每	txg
第	txh
系	txi
後	txt
秕	txx
篱	tyb
䇾	tyf
往	tyg
入	tyi
穰	tyk
稿	tym
䄱	tyn
彷	tyn
籴	tyo
簇	tyt
稂	tyv
疘	uad
疳	uaf
冮	uag
瓶	uag
冻	uai
并	uaj
竎	uaj
阈	uak
癀	uam
迸	uap
䇅	uat
瘩	uaw
聞	ubd
闻	ubd
兯	ubj
疖	ubk
疗	ubk
瘾	ubq
逆	ubt
痉	uca
闯	ucd
痛	uce
冯	ucg
㾺	uci
闖	uci
冶	uck
兖	ucq
疤	ucv
竣	ucw
瘙	ucy
馮	ucy
差	uda
郑	udb
闳	udc
㽽	udd
䦒	udd
閆	udd
闫	udd
豢	ude
㓈	udg
䇉	udg
减	udg
着	udh
头	udi
龹	udi
羊	udj
疬	udl
羰	udm
羞	udn
送	udp
羝	udq
拳	udr
⺶	udr
桊	uds
关	udu
券	udv
凑	udw
状	udy
閒	ued
疽	ueg
前	uej
痈	uek
毅	uem
遂	uep
㒸	ueu
豙	ueu
疓	uev
瘃	uey
阖	ufc
㽵	ufd
䦌	ufd
兰	uff
壮	ufg
竍	ufh
阗	ufh
疛	ufi
半	ufk
斗	ufk
閈	ufk
闬	ufk
闱	ufn
闭	uft
凌	ufw
装	ufy
閂	ugd
閏	ugd
闩	ugd
闰	ugd
靖	uge
症	ugh
痞	ugi
辣	ugk
盖	ugl
病	ugm
恙	ugn
羔	ugo
冽	ugq
羲	ugt
羡	ugu
姜	ugv
冱	ugx
癍	ugy
疲	uhc
㾇	uhd
阒	uhd
癯	uhh
䇂	uhk
丫	uhk
夔	uht
疵	uhx
㽷	uii
痧	uii
閖	uii
阔	uit
瘠	uiw
冰	uiy
鄣	ujb
間	ujd
间	ujd
彰	uje
音	ujf
疸	ujg
痋	uji
閩	uji
闽	uji
章	ujj
瘟	ujl
意	ujn
竟	ujq
赣	ujt
韶	ujv
部	ukb
問	ukd
问	ukd
㖖	ukf
咅	ukf
瓿	ukg
冲	ukh
剖	ukj
癌	ukk
总	ukn
况	ukq
痼	uld
兽	ulg
曾	ulj
㾝	ulk
閘	ulk
閳	ulk
闸	ulk
阃	uls
瘰	ulx
疫	umc
㾄	umd
端	umd
凋	umf
敝	umi
閴	umi
疝	umk
閊	umk
瘿	umm
竌	umn
疯	umq
商	umw
癜	una
阚	unb
翊	ung
瘕	unh
悶	uni
闷	uni
癖	unk
䇃	unn
乵	unn
疡	unr
㽶	unv
决	unw
普	uog
焛	uoi
疢	uoi
痰	uoo
瘘	uov
帝	upm
旁	upy
阍	uqa
郊	uqb
㾣	uqd
䦦	uqd
奖	uqd
将	uqf
凎	uqg
癣	uqg
浆	uqi
阄	uqj
痪	uqm
疱	uqn
桨	uqs
效	uqt
交	uqu
净	uqv
次	uqw
疚	uqy
瓣	urc
䦐	urk
閪	usd
瘭	usf
尊	usg
㓅	ush
閑	usi
闲	usi
疔	usk
閅	usk
鹇	usq
新	usr
亲	usu
凇	usw
疾	utd
产	ute
閁	ute
冼	utf
首	uth
痢	utj
阁	utk
疙	utn
疼	utu
痿	utv
阙	uub
痒	uud
閚	uud
闁	uud
竝	uug
辡	uuh
阐	uuj
㾕	uuk
阅	uuk
痫	uus
立	uuu
閰	uvd
痕	uve
妾	uvf
妆	uvg
瘦	uvh
兼	uvo
阋	uvq
瘐	uvw
阀	uwa
疮	uwb
疹	uwe
瘵	uwf
痊	uwg
閃	uwi
闪	uwi
疥	uwj
益	uwl
瘊	uwn
痤	uww
准	uwy
閄	uwy
邶	uxb
背	uxe
弟	uxh
冀	uxl
北	uxn
凝	uxt
辫	uxu
疕	uxv
兹	uxx
訚	uyd
誾	uyd
冫	uyg
门	uyh
閔	uyi
闵	uyi
凛	uyl
闹	uym
阂	uyn
丷	uyt
辨	uyt
辩	uyu
閍	uyv
阆	uyv
瘁	uyw
痃	uyx
媒	vaf
妅	vag
姬	vah
舁	vaj
毁	vam
妪	vaq
娆	vat
㚤	vay
㜽	vbf
㛅	vbg
好	vbg
媸	vbh
邚	vbh
她	vbn
婀	vbs
既	vca
即	vcb
驽	vcc
妈	vcg
始	vck
努	vcl
帑	vcm
妑	vcn
怒	vcn
厹	vcu
弩	vcx
奴	vcy
媽	vcy
娠	vdf
妬	vdg
姑	vdg
㚑	vdu
垦	vef
姐	veg
艮	vei
奶	ven
退	vep
那	vfb
妓	vfc
娃	vff
奸	vfh
妹	vfi
卆	vfj
媾	vfj
嬉	vfk
妩	vfq
孀	vfs
姥	vft
寻	vfu
妍	vga
婧	vge
嫣	vgh
嫩	vgk
娅	vgo
婕	vgv
姨	vgx
叟	vhc
肀	vhk
隶	vii
肃	vij
逮	vip
姚	viq
妙	vit
录	viu
旭	vjd
旮	vjf
妲	vjg
娼	vjj
媪	vjl
巢	vjs
邵	vkb
邕	vkc
娟	vke
召	vkf
叴	vkf
如	vkg
劭	vkl
娲	vkm
恕	vkn
迢	vkp
絮	vkx
姻	vld
甾	vlf
㚼	vlg
舅	vll
邋	vlq
嫘	vlx
妯	vmg
奾	vmh
㞪	vmj
姗	vmm
㛝	vmy
㐇	vnb
妞	vnf
彐	vng
媚	vnh
妃	vnn
刀	vnt
㣽	vnu
鼠	vnu
妮	vnx
姒	vny
䊆	vou
灵	vou
災	vou
嫁	vpe
婶	vpj
帚	vpm
婉	vpq
嫔	vpr
姹	vpt
巡	vpv
廵	vpv
辺	vpv
婚	vqa
兒	vqb
娩	vqk
舄	vqo
夛	vqu
妁	vqy
妡	vrh
姝	vri
婢	vrt
嫖	vsf
㛉	vsg
奵	vsh
杂	vsu
妖	vtd
尹	vte
妊	vtf
姓	vtg
臼	vth
群	vtk
媲	vtl
九	vtn
娥	vtr
姀	vty
姘	vua
㛙	vuh
婵	vuj
嫡	vum
姣	vuq
娴	vus
嫉	vut
嫌	vuv
娣	vux
㚣	vvf
娜	vvf
奻	vvg
妇	vvg
嫂	vvh
女	vvv
刅	vwi
臾	vwi
妗	vwy
姆	vxg
妣	vxx
訄	vyd
娮	vyg
丸	vyi
刃	vyi
刄	vyi
妫	vyl
妨	vyn
婷	vyp
嬷	vys
㚧	vyt
娘	vyv
妏	vyy
偌	wad
仝	waf
仜	wag
伢	wah
借	waj
黛	wal
贷	wam
牮	war
伐	wat
供	waw
代	way
戗	wba
仓	wbb
仔	wbg
佴	wbg
创	wbj
他	wbn
颂	wcd
俑	wce
㐷	wcg
瓮	wcg
翁	wcn
侔	wcr
俟	wct
公	wcu
俊	wcw
仅	wcy
仏	wcy
傌	wcy
佐	wda
侑	wde
侉	wdf
仨	wdg
估	wdg
佦	wdg
佰	wdj
佑	wdk
段	wdm
优	wdn
倚	wds
做	wdt
僚	wdu
傣	wdw
㐲	wdy
伏	wdy
俘	web
䏌	wef
仴	weg
佣	weh
仍	wen
㐱	wer
偾	wfa
会	wfc
儒	wfd
侍	wff
仁	wfg
仕	wfg
什	wfh
仠	wfh
祭	wfi
仐	wfj
癷	wfj
舍	wfk
舆	wfl
璺	wfm
伟	wfn
佬	wft
佞	wfv
付	wfy
倒	wgc
癸	wgd
傅	wge
亼	wgf
全	wgf
仼	wgg
伍	wgg
剑	wgi
便	wgj
合	wgk
僵	wgl
俩	wgm
佤	wgn
俨	wgo
例	wgq
侠	wgu
企	whf
仩	whg
佧	whh
个	whj
侦	whm
候	whn
修	wht
俱	whw
仆	why
俏	wie
倘	wim
偿	wip
佻	wiq
尒	wiu
氽	wiu
㲻	wiy
仦	wiy
俚	wjf
但	wjg
伸	wjh
介	wjj
偶	wjm
偈	wjq
倮	wjs
㕣	wkf
㐰	wkg
俣	wkg
促	wkh
侣	wkk
侃	wkq
保	wks
伵	wlg
佃	wlg
伡	wlh
俥	wlh
伽	wlk
儡	wll
仂	wln
倜	wmf
伷	wmg
佩	wmg
仙	wmh
仚	wmj
侧	wmj
仉	wmn
催	wmw
倔	wnb
倨	wnd
伺	wng
假	wnh
僻	wnk
㐶	wnn
亿	wnn
侯	wnt
亾	wnv
伲	wnx
伈	wny
似	wny
偻	wov
伙	woy
侎	woy
侬	wpe
伫	wpg
倌	wpn
傧	wpr
飠	wpu
倥	wpw
佗	wpx
低	wqa
尣	wqb
爷	wqb
爸	wqc
儋	wqd
釜	wqf
釡	wqf
你	wqi
像	wqj
佝	wqk
侈	wqq
斧	wqr
父	wqu
㐴	wqy
㒶	wrf
伯	wrg
㐿	wrh
件	wrh
伒	wrh
侏	wri
傀	wrq
俾	wrt
佚	wrw
体	wsg
価	wsg
仃	wsh
何	wsk
僳	wso
鸺	wsq
傈	wss
休	wsy
伥	wta
叙	wtc
侨	wtd
任	wtf
亻	wth
俐	wtj
伤	wtl
仡	wtn
途	wtp
俄	wtr
余	wtu
倭	wtv
侮	wtx
八	wty
倦	wud
伴	wuf
位	wug
們	wug
伞	wuh
僮	wuj
倍	wuk
僧	wul
们	wun
傍	wup
佼	wuq
仒	wuu
分	wvb
颁	wvd
健	wvf
㚢	wvg
盆	wvl
贫	wvm
仇	wvn
侵	wvp
倪	wvq
伊	wvt
仞	wvy
耸	wwb
佾	wwe
坐	wwf
丛	wwg
价	wwj
谷	wwk
怂	wwn
仌	wwu
份	wwv
众	www
伦	wwx
仈	wwy
从	wwy
仑	wxb
倾	wxd
华	wxf
僶	wxg
佛	wxj
货	wxm
化	wxn
仳	wxx
禽	wyb
令	wyc
依	wye
储	wyf
詧	wyf
信	wyg
隹	wyg
僦	wyi
侪	wyj
售	wyk
伪	wyl
伉	wym
仿	wyn
焦	wyo
停	wyp
仪	wyq
集	wys
亽	wyu
食	wyv
俯	wyw
伩	wyy
雠	wyy
绒	xad
绀	xaf
紅	xag
红	xag
练	xan
绕	xat
䋙	xbg
䌺	xbg
弭	xbg
鄳	xbh
绌	xbm
䊶	xbn
弛	xbn
经	xca
纾	xcb
缀	xcc
绎	xcf
绐	xck
弝	xcn
紦	xcn
弘	xcy
绂	xdc
毋	xde
绔	xdf
缄	xdg
弼	xdj
顷	xdm
绮	xds
绑	xdt
缭	xdu
紎	xdy
绷	xee
缓	xef
组	xeg
蠡	xej
绶	xep
彖	xeu
绥	xev
级	xey
纭	xfc
疆	xfg
㢨	xfh
缜	xfh
毌	xfk
结	xfk
贯	xfm
续	xfn
鸨	xfq
绪	xft
绫	xfw
紂	xfy
纣	xfy
纯	xgb
㢧	xgd
彑	xgd
缚	xge
弖	xgf
纡	xgf
绠	xgj
缰	xgl
绩	xgm
彝	xgo
线	xgt
母	xgu
彘	xgx
䊼	xhg
引	xhh
缈	xhi
绰	xhj
弔	xhk
颍	xid
绡	xie
绱	xim
纱	xit
糸	xiu
旨	xjf
缇	xjg
绅	xjh
㔬	xjj
弗	xjk
缦	xjl
费	xjm
艴	xjq
缆	xjt
绲	xjx
缉	xkb
绢	xke
紃	xkh
缋	xkh
强	xkj
缲	xkk
织	xkw
細	xlg
细	xlg
幼	xln
糼	xln
辔	xlx
绸	xmf
䌷	xmg
紬	xmg
㢫	xmh
缨	xmm
纲	xmq
纳	xmw
缗	xna
纽	xnf
䋚	xng
䌻	xng
弓	xng
纠	xnh
乣	xnn
幻	xnn
糺	xnn
紀	xnn
纪	xnn
缪	xnw
继	xon
缕	xov
粥	xox
䋛	xoy
综	xpf
绽	xpg
绾	xpn
缤	xpr
缩	xpw
纸	xqa
绝	xqc
䋮	xqg
弥	xqi
绚	xqj
绉	xqv
约	xqy
弧	xrc
絈	xrg
紤	xrh
绵	xrm
缴	xry
缥	xsf
絤	xsg
糽	xsh
缃	xsh
䊾	xsy
张	xta
颖	xtd
乡	xte
纤	xtf
缍	xtg
绺	xth
络	xtk
匕	xtn
绦	xts
终	xtu
飨	xtw
缮	xud
绊	xuf
㢹	xuh
弹	xuj
缯	xul
缔	xup
绞	xuq
缣	xuv
缢	xuw
弱	xux
绿	xvi
缫	xvj
绍	xvk
缁	xvl
㓜	xvn
䊵	xvn
糿	xvn
纫	xvy
缎	xwd
绘	xwf
给	xwg
缑	xwn
纷	xwv
纵	xww
纶	xwx
维	xwy
畿	xxa
缘	xxe
毕	xxf
丝	xxg
繩	xxg
绋	xxj
幽	xxm
弜	xxn
比	xxn
皆	xxr
纟	xxx
缡	xyb
统	xyc
缠	xyj
缟	xym
紡	xyn
纺	xyn
纩	xyt
弦	xyx
紋	xyy
纹	xyy
试	yaa
度	yac
诺	yad
㡲	yae
谋	yaf
訌	yag
讧	yag
讶	yah
谟	yaj
谨	yak
席	yam
谍	yan
庶	yao
讴	yaq
诬	yaw
谎	yay
郭	ybb
诹	ybc
享	ybf
斈	ybf
斊	ybf
誀	ybg
邝	ybh
邡	ybh
亨	ybj
㐫	ybk
㓙	ybk
离	ybm
訑	ybn
烹	ybo
鹑	ybq
敦	ybt
熟	ybv
弃	yca
序	ycb
育	yce
译	ycf
広	yci
诒	yck
充	ycq
诶	yct
詁	ydg
诂	ydg
庆	ydi
诽	ydj
斋	ydm
诚	ydn
诙	ydo
庞	ydx
彣	yee
谖	yef
䚴	yeg
诅	yeg
裔	yem
䚮	yen
谣	yer
䚲	yet
哀	yeu
衣	yeu
诼	yey
庋	yfc
庄	yfd
诗	yff
計	yfh
訐	yfh
计	yfh
讦	yfh
讲	yfj
诘	yfk
谳	yfm
读	yfn
庑	yfq
诸	yft
対	yfy
討	yfy
讨	yfy
斌	yga
主	ygd
请	yge
证	ygh
语	ygk
谏	ygl
廒	ygq
评	ygu
谑	yha
訨	yhg
让	yhg
店	yhk
卞	yhu
訃	yhy
讣	yhy
应	yid
诮	yie
氷	yii
谠	yip
京	yiu
䚱	yiy
亯	yjf
廛	yjf
斉	yjf
齊	yjf
䚯	yjh
刘	yjh
亣	yjj
齐	yjj
谩	yjl
谒	yjq
课	yjs
蚉	yju
吝	ykf
误	ykg
訓	ykh
训	ykh
襄	ykk
识	ykw
谓	yle
亩	ylf
畗	ylf
訵	ylg
䛅	ylh
库	ylk
庘	ylk
庫	ylk
谡	ylw
为	yly
亢	ymb
设	ymc
庙	ymd
调	ymf
䛆	ymg
訕	ymh
讪	ymh
高	ymk
讥	ymn
讽	ymq
讷	ymw
㐎	ynb
㐔	ynb
邙	ynb
戾	ynd
户	yne
讯	ynf
詡	yng
诩	yng
盲	ynh
応	yni
永	yni
鹿	ynj
启	ynk
遍	ynm
記	ynn
记	ynn
刻	ynt
忞	ynu
悥	ynu
戽	ynu
亡	ynv
廖	ynw
房	yny
訫	yny
弈	yoa
孪	yob
变	yoc
奕	yod
蛮	yoj
峦	yom
恋	yon
谈	yoo
迹	yop
鸾	yoq
挛	yor
栾	yos
㪰	you
亦	you
娈	yov
弯	yox
詸	yoy
這	ypd
谊	ype
这	ypi
膏	ypk
诨	ypl
亮	ypm
亭	yps
毫	ypt
䢍	ypv
底	yqa
诡	yqd
廨	yqe
义	yqi
询	yqj
谗	yqk
庖	yqn
诳	yqt
谄	yqv
诟	yrg
䜣	yrh
訢	yrh
诛	yri
庍	yrk
庳	yrt
亵	yrv
诉	yry
訂	ysh
订	ysh
床	ysi
谭	ysj
庁	ysk
诃	ysk
麻	yss
旗	yta
施	ytb
话	ytd
诱	yte
许	ytf
旆	ytg
诈	yth
谢	ytm
旋	ytn
族	ytt
诿	ytv
诲	ytx
䚺	yty
放	yty
訸	yty
㡴	yud
详	yud
谫	yue
谰	yug
䛨	yuh
谙	yuj
说	yuk
谪	yum
谱	yuo
谤	yup
谘	yuq
谚	yut
谦	yuv
谥	yuw
朗	yvc
良	yve
唐	yvh
康	yvi
诏	yvk
訅	yvn
庚	yvw
讼	ywc
诊	ywe
府	ywf
诠	ywg
庂	ywi
褒	ywk
庥	yws
夜	ywt
於	ywu
座	yww
论	ywx
㫃	ywy
认	ywy
譝	yxg
率	yxi
诣	yxj
畜	yxl
䚰	yxn
雍	yxt
玄	yxu
庀	yxv
庇	yxx
廓	yyb
㢇	yyd
亠	yyg
誩	yyg
谅	yyi
丶	yyl
訪	yyn
讠	yyn
访	yyn
议	yyq
廊	yyv
谇	yyw
言	yyy
