工	a
了	b
以	c
在	d
有	e
地	f
一	g
上	h
不	i
是	j
中	k
国	l
同	m
民	n
为	o
这	p
我	q
的	r
要	s
和	t
产	u
发	v
人	w
经	x
主	y
式	aa
节	ab
芭	ac
苦	ad
功	ae
革	af
七	ag
牙	ah
东	ai
划	aj
或	ak
苗	al
贡	am
艺	an
蘑	ao
芝	ap
匹	aq
区	ar
莆	as
攻	at
蒋	au
切	av
共	aw
药	ax
芳	ay
陈	ba
子	bb
取	bc
承	bd
阴	be
际	bf
卫	bg
耻	bh
孙	bi
阳	bj
职	bk
阵	bl
出	bm
也	bn
耿	bo
辽	bp
陶	bq
孤	br
阿	bs
降	bt
联	bu
限	bv
队	bw
陛	bx
及	by
戏	ca
邓	cb
双	cc
参	cd
能	ce
对	cf
马	cg
犋	ch
台	ck
观	cm
予	cn
物	cq
牺	cs
矣	ct
艰	cv
难	cw
牝	cx
叉	cy
左	da
破	db
友	dc
大	dd
历	de
夺	df
三	dg
还	dh
砂	di
百	dj
右	dk
面	dl
而	dm
成	dn
矿	do
达	dp
克	dq
原	dr
厅	ds
故	dt
辜	du
肆	dv
其	dw
龙	dx
太	dy
肛	ea
服	eb
肥	ec
须	ed
朋	ee
肚	ef
且	eg
毡	eh
膛	ei
胆	ej
加	ek
舆	el
觅	em
力	en
脏	eo
边	ep
胸	eq
貌	er
采	es
用	et
胶	eu
妥	ev
办	ew
脂	ex
肪	ey
域	fa
坡	fb
支	fc
城	fd
协	fe
寺	ff
十	fg
直	fh
示	fi
刊	fj
吉	fk
雷	fl
南	fm
志	fn
赤	fo
过	fp
无	fq
垢	fr
某	fs
才	ft
增	fu
雪	fv
零	fw
坶	fx
坊	fy
开	ga
击	gb
到	gc
天	gd
表	ge
于	gf
五	gg
下	gh
求	gi
理	gj
事	gk
画	gl
现	gm
与	gn
亚	go
琛	gp
万	gq
珀	gr
末	gs
麦	gt
来	gu
妻	gv
珍	gw
互	gx
玉	gy
瞒	ha
眸	hc
非	hd
肯	he
睦	hf
睛	hg
步	hh
叔	hi
旧	hj
占	hk
卤	hl
贞	hm
虑	hn
虚	ho
瞎	hp
餐	hq
睥	hr
盯	hs
睡	ht
瞳	hu
眼	hv
具	hw
此	hx
虔	hy
江	ia
波	ib
汉	ic
尖	id
肖	ie
汗	if
光	ig
小	ih
水	ii
浊	ij
溃	ik
泗	il
油	im
沁	in
渡	io
党	ip
沟	iq
汽	ir
浦	is
少	it
洋	iu
当	iv
没	iw
涨	ix
济	iy
晓	ja
最	jb
坚	jc
晨	jd
明	je
时	jf
量	jg
早	jh
晃	ji
昌	jj
蝇	jk
曙	jl
遇	jm
电	jn
显	jo
蛇	jp
晚	jq
蚯	jr
果	js
鉴	jt
暗	ju
归	jv
蛤	jw
昆	jx
影	jy
呀	ka
啊	kb
吧	kc
顺	kd
另	ke
叶	kf
号	kg
足	kh
吵	ki
虽	kj
吕	kk
喂	kl
员	km
叫	kn
嘛	ko
喧	kp
兄	kq
听	kr
呆	ks
吃	kt
咬	ku
啸	kv
只	kw
哟	kx
唁	ky
轼	la
囝	lb
轻	lc
因	ld
男	le
团	lf
车	lg
四	lh
辊	lj
回	lk
田	ll
轴	lm
思	ln
辘	lo
连	lp
罗	lq
斩	lr
困	ls
略	lt
较	lu
轨	lv
界	lw
累	lx
罚	ly
曲	ma
邮	mb
峻	mc
央	md
骨	me
财	mf
赋	mg
由	mh
峭	mi
则	mj
迥	mk
崭	ml
册	mm
岂	mn
赃	mo
迪	mp
见	mq
冈	mr
崧	ms
败	mt
赠	mu
内	mw
幽	mx
丹	my
异	na
敢	nb
怪	nc
居	nd
尾	ne
导	nf
那	ng
收	nh
尿	ni
慢	nj
避	nk
惭	nl
届	nm
已	nn
屡	no
忱	np
懈	nq
怕	nr
懒	ns
改	nt
习	nu
恨	nv
恰	nw
尼	nx
心	ny
席	oa
籽	ob
序	oc
类	od
粗	oe
庄	of
精	og
业	oh
应	oi
烛	oj
燥	ok
库	ol
灿	om
断	on
炎	oo
迷	op
底	oq
粕	or
床	os
庭	ot
粒	ou
数	ov
府	ow
鹿	ox
广	oy
赛	pa
字	pb
害	pd
农	pe
守	pf
家	pg
寂	ph
宵	pi
审	pj
宫	pk
军	pl
宙	pm
官	pn
灾	po
之	pp
宛	pq
宾	pr
宁	ps
客	pt
实	pu
安	pv
空	pw
它	px
社	py
氏	qa
迎	qb
色	qc
然	qd
角	qe
针	qf
钱	qg
外	qh
尔	qi
旬	qj
名	qk
甸	ql
负	qm
包	qn
炙	qo
锭	qp
多	qq
勿	qr
钉	qs
儿	qt
匀	qu
争	qv
欠	qw
锴	qx
久	qy
找	ra
报	rb
反	rc
拓	rd
拥	re
质	rf
后	rg
看	rh
泉	ri
提	rj
扣	rk
押	rl
抽	rm
所	rn
扩	ro
近	rp
换	rq
折	rr
打	rs
手	rt
拉	ru
扫	rv
兵	rw
指	rx
搞	ry
模	sa
李	sb
权	sc
顶	sd
杉	se
票	sf
本	sg
相	sh
档	si
查	sj
可	sk
柬	sl
贾	sm
札	sn
杰	so
枕	sp
构	sq
析	sr
林	ss
枚	st
样	su
根	sv
机	sw
楷	sx
术	sy
长	ta
秀	tb
么	tc
知	td
务	te
等	tf
年	tg
处	th
秒	ti
得	tj
各	tk
备	tl
身	tm
乐	tn
秋	to
乏	tp
稳	tq
稀	tr
条	ts
秩	tt
冬	tu
委	tv
答	tw
每	tx
入	ty
并	ua
疗	ub
痛	uc
头	ud
前	ue
斗	uf
半	ug
着	uh
冰	ui
间	uj
问	uk
闸	ul
端	um
闷	un
普	uo
次	uq
交	ur
亲	us
道	ut
立	uu
妆	uv
闪	uw
北	ux
六	uy
既	va
好	vb
妈	vc
姑	vd
姐	ve
寻	vf
建	vg
肃	vh
录	vi
旭	vj
如	vk
姻	vl
妯	vm
恳	vn
灵	vo
退	vp
婚	vq
婢	vr
杂	vs
九	vt
嫌	vu
妇	vv
妗	vw
姆	vx
妨	vy
代	wa
他	wb
公	wc
估	wd
佣	we
什	wf
全	wg
个	wh
偿	wi
介	wj
保	wk
佃	wl
仙	wm
亿	wn
伙	wo
伫	wp
你	wq
风	wr
休	ws
八	wt
们	wu
分	wv
从	ww
化	wx
信	wy
红	xa
级	xb
弘	xc
顷	xd
组	xe
结	xf
线	xg
引	xh
纱	xi
旨	xj
强	xk
细	xl
贯	xm
纪	xn
继	xo
综	xp
约	xq
绵	xr
缚	xs
乡	xt
弱	xu
绍	xv
给	xw
比	xx
纺	xy
试	ya
享	yb
充	yc
诚	yd
衣	ye
计	yf
证	yg
让	yh
就	yi
刘	yj
训	yk
亩	yl
市	ym
记	yn
亦	yo
亮	yp
询	yq
义	yr
订	ys
放	yt
详	yu
良	yv
认	yw
率	yx
方	yy
匞	aad
匿	aad
芽	aah
戒	aak
苣	aan
荛	aat
戔	aau
藏	aau
荫	abe
芓	abf
茸	abf
卭	abh
邛	abh
蒸	abi
节	abj
茁	abm
芤	abn
艿	abr
萨	abu
匜	abv
芨	aby
茎	aca
芭	acb
苔	ack
茅	acn
莽	ada
苊	adb
茇	adc
戎	ade
苦	adf
葳	adg
荐	adh
若	adk
项	adm
芖	adu
茂	adu
蓁	adw
茏	adx
芼	aeb
莩	aeb
荔	aee
苴	aeg
苚	aej
茄	aek
艻	aer
藐	aer
菜	aes
㣉	aet
功	aet
藤	aeu
荽	aev
苏	aew
鞯	afa
靶	afc
鞑	afd
勒	afe
芏	aff
苷	aff
蒜	afi
芉	afj
革	afj
薹	afk
蕾	afl
贰	afm
苇	afn
鞍	afp
芜	afq
靳	afr
藉	afs
著	aft
苿	afu
蔷	afu
鞭	afw
甙	afy
荆	aga
匡	agd
菁	age
芋	agf
蔫	agh
蕙	agj
芾	agm
七	agn
匚	agn
匸	agn
葬	agq
茉	ags
廾	agt
芙	agu
萋	agv
荑	agx
菲	ahd
䒙	ahf
芷	ahf
苜	ahf
蘧	ahg
菽	ahi
颐	ahk
臣	ahn
茈	ahx
茳	aia
范	aib
菹	aie
萍	aig
东	aii
藻	aik
荡	ain
鸫	aiq
蒎	air
蒲	ais
蔽	ait
䒕	aiu
汞	aiu
茫	aiy
蕞	ajb
莫	ajd
萌	aje
䒤	ajf
昔	ajf
㓚	ajh
划	ajh
草	ajj
蔓	ajl
葛	ajq
蓝	ajt
茧	aju
郾	ajv
葺	akb
叵	akd
戓	akd
勤	akg
匮	akh
颧	akk
莴	akm
燕	aku
蔑	ala
茵	ald
苗	alf
莗	alj
匣	alk
葸	aln
莲	alp
萝	alq
菌	alt
匦	alv
英	amd
苒	amf
苖	amf
茼	amg
匝	amh
苘	amk
苋	amq
貢	amu
贡	amu
黄	amw
苠	ana
艺	anb
芑	anb
巨	and
苢	anf
蔚	anf
蔬	anh
薜	ank
贳	anm
蕊	ann
芯	anu
世	anv
戉	anv
蓼	anw
荩	any
蔗	aoa
炗	aou
苂	aou
薮	aov
菪	apd
劳	ape
蒙	apf
莹	apg
荥	api
萤	apj
营	apk
荤	apl
菅	apn
荧	apo
莺	apq
荣	aps
荦	apt
芝	apu
蓉	apw
萦	apx
芪	aqa
苑	aqb
萏	aqe
菳	aqf
蓟	aqg
荀	aqj
警	aqk
苞	aqn
菊	aqo
葱	aqr
葡	aqs
萄	aqt
芕	aqu
兂	aqv
匹	aqv
旡	aqv
芡	aqw
芍	aqy
芞	arb
葩	arc
菝	ard
苩	arf
茊	arf
瓯	arg
区	ari
芹	arj
匠	ark
欧	arq
萆	art
艾	aru
殴	arw
茜	asf
苯	asg
葙	ash
艼	asj
蕈	asj
苛	ask
菥	asr
㭉	asu
莆	asu
菘	asw
苌	ata
莠	atb
医	atd
芊	atf
董	atg
蓰	ath
莉	atj
蓖	atl
薇	atm
薛	atn
蕃	ato
藜	atq
莪	atr
䒘	atu
䒩	atu
萎	atv
莓	atx
攻	aty
臧	aua
蒴	aub
苙	auf
菛	auf
莘	auj
菩	auk
茨	auq
茭	aur
薪	aus
蒺	aut
蒹	auv
蔺	auw
艽	avb
菇	avd
荨	avf
萧	avh
茹	avk
芀	avr
㓛	avt
切	avt
茛	avu
芄	avy
芁	awb
苍	awb
蓊	awc
茯	awd
蔡	awf
葵	awg
莜	awh
戍	awi
芥	awj
葆	awk
巷	awn
茶	aws
荏	awt
䒔	awu
共	awu
芬	awv
巫	aww
花	awx
恐	awy
荭	axa
芎	axb
荮	axf
莼	axg
蕴	axj
芗	axt
苺	axu
芘	axx
茺	ayc
䓂	ayf
苄	ayh
弋	ayi
蔼	ayj
蓑	ayk
蒿	aym
芦	ayn
葶	ayp
鸢	ayq
芳	ayr
蔟	ayt
芠	ayu
蒂	ayu
莨	ayv
萃	ayw
蓄	ayx
聀	bay
陬	bbc
孕	bbf
䦻	bbg
孖	bbg
聑	bbg
耶	bbh
阤	bbn
陂	bby
陉	bca
聂	bcc
夃	bci
聚	bci
盈	bcl
㿬	bcn
娶	bcv
取	bcy
隋	bda
随	bde
呄	bdf
陌	bdj
颇	bdm
陇	bdx
䎳	beg
阴	beg
毦	ben
阞	bet
孺	bfd
䦹	bfh
皯	bfh
陡	bfh
阱	bfj
阮	bfq
陵	bfw
陆	bgb
卫	bgd
孒	bgd
耳	bgh
隔	bgk
陋	bgm
阢	bgq
陕	bgu
耻	bhg
阯	bhg
陟	bhh
屮	bhk
鼐	bhn
函	bib
丞	big
氶	bii
隙	bij
逊	bip
尕	biu
孙	biy
阥	biy
陧	bjf
阳	bjg
㓟	bjh
刵	bjh
隅	bjm
隰	bjx
亟	bkc
叾	bkf
聩	bkh
陨	bkm
勐	ble
孟	blf
盁	blf
䧃	blg
隈	blg
阵	blh
陣	blh
祟	bmf
聘	bmg
出	bmk
岀	bmk
粜	bmo
孭	bmy
了	bnh
凵	bnh
卩	bnh
阝	bnh
㔾	bnn
䎲	bnn
孔	bnn
巜	bnn
耴	bnn
	bnn
乃	bnt
孞	bnu
恥	bny
耿	boy
阦	boy
䢊	bpd
辸	bpe
院	bpf
辽	bpk
耽	bpq
聍	bps
迆	bpv
陀	bpx
陷	bqe
孢	bqn
聊	bqt
隐	bqv
隍	brg
隗	brq
陴	brt
䧈	bsg
䦺	bsh
耵	bsh
朶	bsu
陠	bsy
聒	btd
阡	btf
隆	btg
阼	bth
孜	bty
隧	bue
障	buj
陪	buk
隘	buw
限	bvy
附	bwf
除	bwg
阶	bwj
队	bwy
乸	bxi
卪	byi
及	byi
孓	byi
孩	byn
防	byt
颈	cad
劲	cae
弁	caj
迳	cap
戏	cay
牫	cay
邓	cbh
牠	cbn
又	ccc
㸭	ccn
㕕	ccu
㕛	ccu
厸	ccy
双	ccy
叁	cdd
牯	cdg
畚	cdl
犄	cds
勇	cee
䏍	cef
甬	cej
牦	cen
通	cep
劝	cet
牞	cet
圣	cff
牡	cfg
㸩	cfh
犊	cfn
对	cfy
驱	cga
骤	cgb
驭	cgc
马	cgd
驵	cge
骊	cgg
骒	cgj
驯	cgk
骡	cgl
骋	cgm
骣	cgn
驼	cgp
驹	cgq
驳	cgr
骠	cgs
骄	cgt
骥	cgu
验	cgw
驴	cgy
厼	ciu
邰	ckb
台	ckf
㸪	ckh
怠	ckn
炱	cko
迨	ckp
牭	clg
牰	cmg
岊	cmj
貟	cmu
贠	cmu
㸽	cmy
巴	cnh
厶	cny
	cny
馬	coi
允	cqb
鸡	cqg
欢	cqw
㸫	crh
牺	csg
牿	ctf
牲	ctg
牧	cty
䍧	cuh
犍	cvg
艰	cvy
皴	cwt
牝	cxn
牳	cxy
叉	cyi
蚤	cyj
犒	cym
犏	cyn
牥	cyt
左	daf
矼	dag
砑	dah
礴	dai
㚏	daj
厝	daj
砸	dam
碟	dan
礞	dap
奁	dar
硗	dat
砌	dav
礤	daw
䂝	day
硭	day
顾	dbd
耷	dbf
矷	dbg
䂙	dbh
㚎	dbj
础	dbm
厄	dbv
破	dby
夿	dcb
磉	dcc
碜	dcd
码	dcg
㕝	dcu
厷	dcu
厺	dcu
友	dcu
雄	dcw
㕆	ddd
磊	ddd
砳	ddg
碱	ddg
厦	ddh
厌	ddi
厣	ddl
硕	ddm
魇	ddr
㚐	ddu
套	ddu
厮	ddw
㹜	ddy
夶	ddy
郁	deb
历	dee
有	def
胡	deg
砽	deh
髭	deh
鬟	del
髯	dem
鬃	dep
鹕	deq
夯	der
劯	det
髟	det
長	deu
鬈	deu
鬣	dev
髹	dew
奔	dfa
磕	dfc
圧	dfd
辰	dfe
圶	dff
夳	dff
奎	dff
矸	dfh
奈	dfi
夲	dfj
厈	dfk
砖	dfn
奢	dft
夺	dfu
压	dfy
研	dga
砘	dgb
戌	dgd
古	dgh
硬	dgj
咸	dgk
礓	dgl
碛	dgm
厉	dgq
丆	dgt
厂	dgt
	dgt
砰	dgu
威	dgv
碡	dgx
砆	dgy
戛	dha
存	dhb
慧	dhd
甭	dhe
在	dhf
歪	dhg
砋	dhg
不	dhi
丰	dhk
艳	dhq
夏	dht
契	dhv
磲	dia
硝	die
夵	diu
泵	diu
砅	diy
厚	djb
百	djf
碍	djg
矵	djh
砷	djh
夰	djj
奄	djn
碣	djq
右	dkf
夻	dkf
夼	dkj
奋	dlf
䦉	dlg
砗	dlh
硨	dlh
㕅	dlk
厍	dlk
厙	dlk
碘	dma
冇	dmb
碳	dmd
碉	dmf
硐	dmg
布	dmh
㞭	dmj
厕	dmj
砚	dmq
頁	dmu
页	dmu
碾	dna
乭	dnb
䎁	dng
嘏	dnh
尴	dnj
盛	dnl
尥	dnq
砀	dnr
怘	dnu
尢	dnv
成	dnv
尬	dnw
尤	dny
盔	dol
磷	doq
矿	dot
灰	dou
碇	dpg
达	dpi
迖	dpi
碗	dpq
牵	dpt
砣	dpx
砥	dqa
克	dqb
㕋	dqd
兢	dqd
确	dqe
碒	dqg
鸪	dqg
砍	dqw
矽	dqy
䂡	drg
砶	drg
斫	drh
爽	drr
碑	drt
硒	dsg
厢	dsh
矴	dsh
㕊	dsi
碴	dsj
厅	dsk
㚓	dsu
䂞	dsu
邦	dtb
寿	dtf
砟	dth
硌	dtk
硇	dtl
砾	dtn
砭	dtp
硪	dtr
故	dty
磋	dua
厥	dub
磙	duc
㕇	dud
砬	dug
羍	duj
辜	duj
厗	duk
碚	duk
碰	duo
冭	duu
磁	dux
厩	dva
碌	dvi
硍	dvy
砼	dwa
期	dwe
基	dwf
奉	dwg
仄	dwi
	dwi
春	dwj
矶	dwn
欺	dwq
斯	dwr
秦	dwt
其	dwu
雁	dww
綦	dwx
矾	dwy
砩	dxj
䂗	dxn
㔫	dxv
砒	dxx
砪	dxy
礅	dyb
硫	dyc
䂴	dyg
䂖	dyi
丈	dyi
太	dyi
态	dyn
磅	dyu
碎	dyw
砇	dyy
腻	eaf
肛	eag
胨	eai
舁	eaj
朦	eap
毁	eaw
郛	ebb
㲌	ebe
孚	ebf
䏪	ebg
乳	ebn
肔	ebn
䏢	eby
䝛	eby
胫	eca
胎	eck
肥	ecn
毪	ect
肱	edc
胯	edf
胚	edh
腌	edj
腼	edl
腠	edw
胧	edx
肰	edy
肽	edy
脬	eeb
月	eee
毝	eee
舀	eef
朋	eeg
㲎	een
鹏	eeq
肋	eet
肜	eet
胁	eew
肢	efc
肚	efg
肝	efh
豻	efh
肼	efj
膨	efk
腩	efm
肟	efn
脖	efp
朊	efq
豺	eft
寽	efu
肘	efy
肫	egb
县	egc
且	egd
助	ege
膈	egk
肺	egm
雎	egw
胰	egx
肤	egy
叟	ehc
腓	ehd
胩	ehh
丯	ehk
胪	ehn
辵	ehu
胱	eig
㲑	eii
毜	eii
盥	eil
㸓	ejf
刖	ejh
腽	ejl
腥	ejt
驾	ekc
加	ekg
肿	ekh
腭	ekk
贺	ekm
迦	ekp
架	eks
袈	eky
胭	eld
舅	ele
胛	elh
腮	eln
爵	elv
腆	ema
胴	emg
肭	emw
㐍	enb
脲	eni
劜	enn
肊	enn
肠	enr
力	ent
鼠	enu
甩	env
毩	eoi
毯	eoo
膦	eoq
䊆	eou
臁	eou
腑	eow
脒	eoy
受	epc
爱	epd
迌	epd
边	epe
脘	epf
腚	epg
腕	epq
膑	epr
胺	epv
腔	epw
胝	eqa
兒	eqb
脆	eqd
氇	eqg
朐	eqk
胞	eqn
舄	eqo
肷	eqw
豹	eqy
胍	erc
胉	erg
貃	erg
肵	erh
腺	eri
䏗	ern
脎	ers
脾	ert
毢	esd
彩	ese
膊	esf
采	esu
腰	esv
膝	esw
䝗	esy
脯	esy
胀	eta
遥	etf
胜	etg
臼	eth
腹	etj
胳	etk
貔	etl
彡	ett
豸	ety
胼	eua
朕	eud
䏠	eug
胖	eug
羘	euh
臆	euj
脱	euk
氆	euo
膳	euu
妥	evf
肗	evg
腱	evg
貂	evk
肍	evn
腿	evp
貇	evy
股	ewc
胗	ewe
脍	ewf
脸	ewg
办	ewi
臾	ewi
肌	ewn
貅	ews
脞	eww
奚	exd
胟	exy
脐	eyj
膻	eyl
脉	eyn
脑	eyr
肪	eyt
膀	eyu
肮	eyw
臃	eyx
霰	fae
卋	faf
霸	faf
㦮	fai
	fai
卉	faj
哉	fak
载	fal
贲	fam
堞	fan
栽	fas
塔	faw
裁	fay
邗	fbh
邯	fbh
壭	fbj
凷	fbk
地	fbn
坡	fby
却	fcb
动	fce
盍	fcl
翅	fcn
运	fcp
魂	fcr
埃	fct
云	fcu
去	fcu
支	fcu
雳	fde
雼	fdf
震	fdf
坧	fdg
坏	fdh
埯	fdj
需	fdm
塬	fdr
堪	fdw
垅	fdx
雮	feb
堋	fee
埒	fef
霾	fej
㘪	fen
霓	feq
㔹	fet
㘦	fet
坛	ffc
亖	fff
圭	fff
雸	fff
坩	ffg
填	ffh
款	ffi
雩	ffn
堵	fft
寺	ffu
垤	fgc
圩	fgf
二	fgg
十	fgh
垣	fgj
塥	fgk
垭	fgo
坪	fgu
越	fha
趣	fhb
霏	fhd
趄	fhe
㱏	fhf
直	fhf
圵	fhg
址	fhg
赴	fhh
趟	fhi
坫	fhk
盐	fhl
起	fhn
墟	fho
趋	fhq
赵	fhr
趱	fht
走	fhu
超	fhv
真	fhw
圤	fhy
霄	fie
霈	fig
示	fiu
墚	fiv
戟	fja
朝	fje
埋	fjf
坦	fjg
刊	fjh
刌	fjh
亓	fjj
	fjj
井	fjk
墁	fjl
塌	fjn
进	fjp
埸	fjq
乾	fjt
翰	fjw
颉	fkd
袁	fke
吉	fkf
埕	fkg
圳	fkh
酃	fkk
埙	fkm
喜	fku
㿻	flf
雷	flf
塄	fly
垌	fmg
圸	fmh
垲	fmn
献	fmu
坝	fmy
垻	fmy
㐊	fnb
㐋	fnb
亏	fnb
䨒	fnf
韦	fnh
墀	fni
霹	fnk
圠	fnn
圮	fnn
圯	fnn
声	fnr
忈	fnu
志	fnu
亐	fnv
块	fnw
坭	fnx
专	fny
郝	fob
赫	fof
圹	fot
㶣	fou
灻	fou
赤	fou
塘	fov
勃	fpb
垸	fpf
壹	fpg
过	fpi
辻	fpk
迀	fpk
毂	fpl
壶	fpo
壳	fpw
索	fpx
坻	fqa
元	fqb
圥	fqb
顽	fqd
鼋	fqk
雹	fqn
远	fqp
均	fqu
无	fqv
坎	fqw
坂	frc
坵	frg
圻	frh
埤	frt
坼	fry
耢	fsa
耔	fsb
耙	fsc
耨	fsd
耗	fse
博	fsf
圢	fsh
霜	fsh
耒	fsi
耦	fsj
坷	fsk
耜	fsn
耧	fso
霖	fss
某	fsu
雬	fsu
耠	fsw
埔	fsy
孝	ftb
嫠	ftd
才	fte
耂	fte
霆	ftf
考	ftg
埏	fth
者	ftj
垧	ftm
埠	ftn
老	ftx
坆	fty
攼	fty
丧	fue
幸	fuf
雴	fuf
垃	fug
垟	fuh
垶	fuh
境	fuj
培	fuk
霎	fuv
雪	fvf
埭	fvi
埽	fvp
垠	fvy
逵	fwf
堠	fwn
垛	fws
赍	fww
堆	fwy
坳	fxe
坶	fxy
墩	fyb
霅	fyf
圡	fyi
霭	fyj
壤	fyk
垓	fyn
壕	fyp
垴	fyr
雱	fyr
坊	fyt
雯	fyu
坑	fyw
坟	fyy
邢	gab
形	gae
玒	gag
武	gah
戋	gai
弄	gaj
开	gak
盏	gal
瑛	gam
珙	gaw
㺭	gbg
珥	gbg
邞	gbh
击	gbk
屯	gbn
玻	gby
至	gcf
玛	gcg
丟	gcu
㺨	gcy
瑚	gde
环	gdh
天	gdi
蚕	gdj
吞	gdk
顼	gdm
忝	gdn
琦	gds
㺯	gdu
琪	gdw
珑	gdx
㺴	gdy
青	gef
燹	geg
玥	geg
豕	gei
珈	gek
靓	gem
逐	gep
静	geq
玏	get
瑶	get
表	geu
珐	gfc
玵	gfg
玕	gfh
于	gfk
盂	gfl
玮	gfn
迂	gfp
玩	gfq
琶	ggc
琢	gge
王	ggg
玨	ggg
球	ggi
替	ggj
一	ggl
瑟	ggn
琴	ggw
琵	ggx
㚘	ggy
玞	ggy
珏	ggy
㠪	ghd
正	ghd
㺺	ghg
焉	ghg
下	ghi
丅	ghk
玷	ghk
丐	ghn
璨	ghq
政	ght
琥	ghw
㺪	ghy
琐	gim
亘	gjg
㺫	gjh
惠	gjh
丌	gjk
更	gjr
琨	gjx
吾	gkf
囊	gkh
玔	gkh
卅	gkk
副	gkl
融	gkm
带	gkp
吏	gkr
豆	gku
玾	glh
卌	glk
琏	glp
遭	gma
瑞	gmd
再	gmf
珊	gmm
规	gmq
責	gmu
责	gmu
丙	gmw
丽	gmy
珼	gmy
珉	gna
㐏	gnb
琚	gnd
珝	gng
瑕	gnh
㝳	gni
玌	gnn
玘	gnn
瓦	gnn
戸	gnr
忢	gnu
丂	gnv
亚	god
垩	gof
灭	goi
晋	goj
恶	gon
琰	goo
严	got
璞	gou
瑭	gov
辷	gpd
迋	gpd
琮	gpf
珲	gpl
琬	gpq
殛	gqb
殆	gqc
万	gqe
殖	gqf
残	gqg
琻	gqg
歹	gqi
列	gqj
趸	gqk
殃	gqm
迈	gqp
殉	gqq
殊	gqt
殚	gqu
兀	gqv
兀	gqv
殓	gqw
死	gqx
玖	gqy
碧	grd
珀	grg
瑰	grq
玎	gsh
末	gsi
亍	gsj
珂	gsk
琳	gss
珠	gtf
珩	gtg
珞	gtk
璁	gtl
麦	gtu
玫	gty
夹	gud
平	guf
珜	guh
璋	guj
瑙	gvt
珢	gvy
玳	gwa
瑜	gwg
玑	gwn
兲	gwu
玢	gwv
玐	gwy
玲	gwy
互	gxd
纛	gxh
素	gxi
毒	gxu
夷	gxw
琉	gyc
斑	gyg
琂	gyg
乁	gyi
玉	gyi
玊	gyi
璃	gyr
班	gyt
琅	gyv
玟	gyy
虐	hag
瞄	hal
眍	har
眲	hbg
齒	hbj
眙	hck
攴	hcu
睃	hcw
睚	hdf
䀦	hdg
悲	hdh
狊	hdu
虏	hee
肯	hef
眀	heg
瞍	heh
眊	hen
瞬	hep
睨	heq
睬	hes
䀐	het
歧	hfc
眭	hff
盰	hfh
睹	hft
眛	hfy
盹	hgb
丄	hgd
盱	hgf
凸	hgh
睐	hgu
睫	hgv
频	hhd
䀠	hhg
止	hhg
目	hhh
步	hhr
卡	hhu
歨	hhu
瞿	hhw
眦	hhx
卜	hhy
瞠	hip
眇	hit
尗	hiu
㫖	hjf
旧	hjg
卓	hjj
桌	hjs
战	hka
占	hkf
虞	hkg
觇	hkm
乩	hkn
点	hko
盀	hlf
卣	hln
貞	hmu
贞	hmu
眠	hna
瞰	hnb
鼎	hnd
凹	hnh
虑	hni
鸬	hnq
卢	hnr
瞩	hnt
忐	hnu
虚	hod
觑	hom
瞵	hoq
眯	hoy
壑	hpg
瞑	hpj
眈	hpq
見	hqb
瞻	hqd
眺	hqi
眵	hqq
㱑	hqu
歺	hqu
睁	hqv
虗	hrd
盺	hrh
瞟	hsf
盯	hsh
䀯	hsy
䖍	hti
瞅	hto
眨	htp
眻	huh
睇	hux
眼	hvy
齿	hwb
彪	hwe
瞪	hwg
仧	hwu
具	hwu
凣	hwv
虎	hwv
瞧	hwy
砦	hxd
些	hxf
赀	hxm
此	hxn
觜	hxq
柴	hxs
䖈	hxv
雌	hxw
紫	hxx
訾	hxy
虔	hyi
眆	hyt
眩	hyx
盿	hyy
漭	iad
江	iag
漠	iaj
灌	iak
潢	iam
㲺	ian
汇	ian
涝	iap
鸿	iaq
沤	iar
柒	ias
浇	iat
沏	iav
洪	iaw
㳀	iay
滠	ibc
泐	ibe
汓	ibg
洱	ibg
涵	ibi
凼	ibk
氾	ibn
池	ibn
婆	ibv
滁	ibw
波	iby
泾	ica
渗	icd
涌	ice
泽	icg
治	ick
滩	icw
汉	icy
湖	ide
沯	idf
涯	idf
沰	idg
沽	idg
沣	idh
尜	idi
淹	idj
湎	idl
源	idr
涛	idt
尖	idu
湛	idw
泷	idx
汏	idy
汰	idy
汱	idy
浮	ieb
淝	iec
滔	iee
㳫	ief
肖	ief
㳉	ieg
沮	ieg
溲	ieh
削	iej
逍	iep
氻	iet
淫	iet
溪	iex
灞	ifa
法	ifc
濡	ifd
坔	iff
尘	iff
汢	ifg
泔	ifg
汁	ifh
汗	ifh
潮	ifj
洁	ifk
污	ifn
渤	ifp
沅	ifq
渚	ift
沬	ify
浅	iga
沌	igb
添	igd
清	ige
汪	igg
沔	igh
洹	igj
滞	igk
渍	igm
沫	igs
涞	igu
兴	igw
沚	ihg
泪	ihg
涉	ihh
淑	ihi
淖	ihj
沾	ihk
浈	ihm
滤	ihn
瀣	ihq
濉	ihw
消	iie
淌	iim
沙	iit
沝	iiy
瀑	ija
沓	ijf
汨	ijg
汩	ijg
温	ijl
溻	ijn
湿	ijo
渴	ijq
滥	ijt
混	ijx
浊	ijy
涓	ike
呇	ikf
汌	ikh
渑	ikj
澡	ikk
涡	ikm
涸	ild
渭	ile
泴	ilf
涠	ilf
畄	ilf
畓	ilf
㳑	ilg
沺	ilg
泗	ilg
㳌	ilh
洄	ilk
涟	ilp
渐	ilr
泅	ilw
漯	ilx
澧	ima
湍	imd
滑	ime
油	img
汕	imh
测	imj
尚	imk
涔	imw
浿	imy
泯	ina
尐	inb
潺	inb
漏	inf
渥	ing
湄	inh
涮	inm
㲸	inn
汜	inn
汤	inr
泌	int
濯	inw
泥	inx
沁	iny
瀵	iol
淡	ioo
㲿	iot
濂	iou
溏	iov
漉	iox
洣	ioy
黉	ipa
学	ipb
	ipb
浓	ipe
尝	ipf
泻	ipg
泶	ipi
溟	ipj
常	ipk
浑	ipl
觉	ipm
涫	ipn
沈	ipq
滨	ipr
泞	ips
喾	ipt
滓	ipu
沉	ipw
沱	ipx
澹	iqd
淦	iqg
洮	iqi
洵	iqj
浼	iqk
涣	iqm
泡	iqn
淘	iqt
汐	iqy
汹	irb
淆	ird
派	ire
㳋	irg
泊	irg
沂	irh
汽	irn
浙	irr
浜	irw
㲼	iry
激	iry
漂	isf
洒	isg
汀	ish
潭	isj
河	isk
淅	isr
淋	iss
漆	isw
沐	isy
浦	isy
弊	ita
沲	itb
活	itd
少	ite
洗	itf
洚	itg
省	ith
潲	iti
洛	itk
洫	itl
澳	itm
憋	itn
潘	ito
泛	itp
鳖	itq
涤	its
海	itx
㳊	ity
敝	ity
汷	ity
溯	iub
滚	iuc
湔	iue
泣	iug
㳯	iuh
洋	iuh
漳	iuj
涪	iuk
澜	ius
溢	iuw
滋	iux
溉	iva
当	ivf
汝	ivg
渌	ivi
沼	ivk
淄	ivl
氿	ivn
浸	ivp
染	ivs
梁	ivw
泿	ivy
涩	ivy
沧	iwb
脊	iwe
浍	iwf
洽	iwg
沿	iwk
㲹	iwn
濮	iwo
滏	iwr
氼	iwu
汾	iwv
浴	iww
沦	iwx
汃	iwy
汄	iwy
淮	iwy
泓	ixc
澠	ixg
沸	ixj
溺	ixu
潍	ixw
淳	iyb
流	iyc
瀛	iye
注	iyg
汴	iyh
澶	iyl
沪	iyn
湾	iyo
濠	iyp
漓	iyr
汸	iyt
洲	iyt
滴	iyu
浪	iyv
液	iyw
泫	iyx
汶	iyy
蟒	jad
虹	jag
蚜	jah
㫒	jaj
蜡	jaj
蜮	jak
蠛	jal
蟥	jam
蝶	jan
蝾	jap
暴	jaw
㫗	jbf
虸	jbg
蜢	jbl
虵	jbn
蚾	jby
肾	jce
蚂	jcg
贤	jcm
蚆	jcn
蛑	jct
竖	jcu
紧	jcx
蝴	jde
䖨	jdg
蛄	jdg
蚌	jdh
晟	jdn
螈	jdr
旲	jdu
蜞	jdw
蜉	jeb
冐	jef
明	jeg
蚏	jeg
螋	jeh
盟	jel
蚝	jen
暧	jep
㫑	jet
野	jfc
里	jfd
圼	jff
蛙	jff
蚶	jfg
旪	jfh
旰	jfh
虷	jfh
旱	jfj
蟛	jfk
蝻	jfm
暑	jft
䖞	jfy
时	jfy
昧	jfy
蛭	jgc
昊	jgd
晴	jge
旦	jgf
旺	jgg
蚟	jgg
题	jgh
晤	jgk
师	jgm
蛱	jgu
㫙	jgy
蚨	jgy
勖	jhe
㫔	jhf
冒	jhf
刂	jhh
申	jhk
畅	jhn
虲	jhy
蛸	jie
螳	jip
曝	jja
昌	jjf
昍	jjg
蚎	jjg
蛳	jjg
晶	jjj
蝎	jjq
蜾	jjs
䖵	jjy
蜈	jkg
蜗	jkm
曼	jlc
昷	jlf
蛊	jlf
蝈	jlg
䖬	jlh
蛼	jlh
蛔	jlk
螺	jlx
蛐	jma
映	jmd
蜩	jmf
蚰	jmg
帅	jmh
旵	jmj
蚬	jmq
蚋	jmw
蛽	jmy
蛡	jng
暇	jnh
虬	jnn
遢	jnp
曳	jnt
电	jnv
曜	jnw
昵	jnx
显	jof
旷	jot
㫧	jou
炅	jou
蝼	jov
炚	joy
暄	jpg
螟	jpj
晕	jpl
蜿	jpq
晏	jpv
昂	jqb
蟾	jqd
晁	jqi
冕	jqk
易	jqr
昴	jqt
昀	jqu
遏	jqw
蚯	jrg
昕	jrh
蚚	jrh
蜱	jrt
颗	jsd
螵	jsf
晒	jsg
虰	jsh
果	jsi
蚵	jsk
夥	jsq
晰	jsr
杲	jsu
晡	jsy
蚞	jsy
蜅	jsy
蜂	jtd
蛛	jtf
星	jtg
昨	jth
蝮	jtj
晌	jtm
虼	jtn
蟠	jto
蛾	jtr
蝌	jtu
晦	jtx
览	jty
昱	juf
曦	jug
蛘	juh
蜕	juk
蜣	jun
蛟	jur
蝤	jus
昗	juu
蟮	juu
旯	jvb
妟	jvf
归	jvg
昭	jvk
旫	jvt
虭	jvt
蛝	jvy
蚣	jwc
㬰	jwi
蚧	jwj
虮	jwn
晔	jwx
暹	jwy
㫐	jxb
蚴	jxe
蠅	jxg
蚓	jxh
暾	jyb
蛀	jyg
景	jyi
蛴	jyj
曩	jyk
蝙	jyn
昘	jyr
蚁	jyr
昉	jyt
蚄	jyt
蝣	jyt
旻	jyu
螃	jyu
螂	jyv
蟀	jyx
旼	jyy
蚊	jyy
喏	kad
嘞	kaf
叿	kag
哐	kag
噶	kaj
喵	kal
咂	kam
喋	kan
唠	kap
哎	kar
哓	kat
哄	kaw
嚆	kay
嗫	kbc
咠	kbf
吇	kbg
咡	kbg
叩	kbh
咄	kbm
吔	kbn
吼	kbn
吸	kby
邑	kcb
嗓	kcc
嗵	kce
吗	kcg
吧	kcn
吮	kcq
唉	kct
唆	kcw
叹	kcy
呃	kdb
呖	kde
喹	kdf
咕	kdg
嘎	kdh
喱	kdj
咴	kdo
哒	kdp
㕦	kdu
嘹	kdu
嘶	kdw
咙	kdx
吠	kdy
肙	kef
咀	keg
嗖	keh
别	kej
咖	kek
嚼	kel
㕰	ken
嗳	kep
鹃	keq
另	ker
叻	ket
喷	kfa
吱	kfc
嚅	kfd
哇	kff
吐	kfg
咁	kfg
叶	kfh
嘲	kfj
嘻	kfk
鄙	kfl
喃	kfm
哧	kfo
噎	kfp
呒	kfq
哮	kft
嚯	kfw
吋	kfy
味	kfy
吨	kgb
吴	kgd
啄	kge
呈	kgf
㕵	kgg
㕶	kgg
吓	kgh
哽	kgj
唔	kgk
啧	kgm
哑	kgo
逞	kgp
咧	kgq
唛	kgt
咦	kgx
呋	kgy
距	kha
跛	khb
踊	khc
跨	khd
啃	khe
跬	khf
	khf
践	khg
趾	khh
踏	khi
踢	khj
中	khk
盅	khl
蹦	khm
忠	khn
嘘	kho
踪	khp
跑	khq
踬	khr
路	kht
足	khu
跟	khv
趴	khw
嘴	khx
卟	khy
啵	kib
哨	kie
咣	kig
唢	kim
嘬	kjb
哩	kjf
呻	kjh
唱	kjj
喁	kjm
黾	kjn
喝	kjq
虽	kju
骂	kkc
器	kkd
吕	kkf
吅	kkg
串	kkh
品	kkk
鼍	kkl
咒	kkw
咽	kld
喟	kle
嘿	klf
呬	klg
呷	klh
唓	klh
嗣	kma
郧	kmb
喘	kmd
勋	kme
啁	kmf
吊	kmh
嘤	kmm
哕	kmq
员	kmu
員	kmu
呐	kmw
呗	kmy
唄	kmy
叼	kng
噼	knk
唰	knm
㕧	knt
嘱	knt
呢	knx
吣	kny
啖	koo
噗	kou
喽	kov
吙	koy
咪	koy
噻	kpa
哝	kpe
嘧	kpn
咛	kps
喀	kpt
嚓	kpw
兄	kqb
唫	kqg
鸣	kqg
唤	kqm
咆	kqn
哆	kqq
吻	kqr
啕	kqt
吹	kqw
唣	kra
呱	krc
唏	krd
哌	kre
㕷	krg
听	krh
史	kri
啪	krr
啤	krt
啦	kru
嘌	ksf
哂	ksg
叮	ksh
喳	ksj
呵	ksk
啉	kss
呆	ksu
㕲	ksy
哺	ksy
噬	kta
唾	ktg
咱	kth
咯	ktk
响	ktm
啾	kto
哦	ktr
呼	ktu
呚	kty
咊	kty
嗟	kua
嗍	kub
㕸	kug
㖕	kuh
咩	kuh
喑	kuj
噌	kul
唼	kuv
嗌	kuw
唧	kvb
呶	kvc
㕤	kvn
叧	kvr
叨	kvt
哏	kvy
呛	kwb
嗡	kwc
咐	kwf
哈	kwg
叽	kwn
嗲	kwr
咻	kws
只	kwu
吩	kwv
唑	kww
哗	kwx
㕥	kwy
叭	kwy
喙	kxe
吲	kxh
叱	kxn
哔	kxx
吆	kxy
呣	kxy
哼	kyb
唷	kyc
唁	kyg
哜	kyj
嚷	kyk
咏	kyn
嚎	kyp
㕫	kyt
嗾	kyt
啼	kyu
啷	kyv
吭	kyw
呅	kyy
羁	laf
㘟	lak
囝	lbd
辄	lbn
墼	lbw
轰	lcc
㘝	lci
囜	lci
轭	ldb
固	ldd
囿	lde
罟	ldf
軲	ldg
轱	ldg
罘	ldh
因	ldi
罨	ldj
恩	ldn
畸	lds
畴	ldt
辏	ldw
畎	ldy
軑	ldy
轪	ldy
㘞	lee
胃	lef
䢁	leg
軞	len
男	ler
㽖	let
䡃	let
嬲	lev
罢	lfc
畦	lff
軒	lfh
轩	lfh
団	lfi
䍐	lfj
辕	lfk
罱	lfm
转	lfn
黑	lfo
园	lfq
圉	lfu
囤	lgb
轾	lgc
囯	lgd
畏	lge
軖	lgg
罡	lgh
畀	lgj
辐	lgk
辆	lgm
䡍	lgy
国	lgy
畉	lgy
罪	lhd
罩	lhj
㐃	lhk
皿	lhn
囦	lii
眔	liu
軣	liu
辑	lkb
回	lkd
軎	lkf
䡅	lkh
甽	lkh
圆	lkm
轵	lkw
畕	llf
䡒	llg
圜	llg
䡛	llh
㘡	llk
軸	lmg
轴	lmg
軕	lmh
買	lmu
辋	lmu
辗	lna
囙	lnd
翈	lng
軋	lnn
轧	lnn
思	lnu
罹	lnw
辚	loq
䍘	lou
辖	lpd
连	lpk
連	lpk
畹	lpq
鸭	lqg
蜀	lqj
逻	lqp
囫	lqr
罗	lqu
软	lqw
畈	lrc
堑	lrf
斩	lrh
斬	lrh
暂	lrj
錾	lrq
椠	lrs
町	lsh
困	lsi
圃	lsi
甼	lsj
轲	lsk
䍒	lsu
輔	lsy
辅	lsy
轿	ltd
轶	ltg
囷	lti
轹	ltn
图	ltu
畋	lty
䢂	lug
畔	lug
疃	luj
罾	lul
囡	lvd
㚻	lvf
婁	lvf
轺	lvk
辎	lvl
軌	lvn
轨	lvn
轫	lvy
轸	lwe
输	lwg
囚	lwi
䡄	lwn
轮	lwx
㽗	lwy
囹	lwy
毗	lxx
辙	lyc
圁	lyd
詈	lyf
曲	mad
㞬	maf
屸	mag
岈	mah
岽	mai
冊	mak
嵘	map
岖	mar
典	maw
戝	may
㕀	mbb
㞨	mbg
邖	mbh
邮	mbh
郥	mbh
貤	mbn
㞧	mbr
屷	mbt
岌	mby
岥	mby
貱	mby
㽕	mcb
岜	mcb
峄	mcg
禸	mci
贻	mck
贿	mde
岩	mdf
岵	mdg
酆	mdh
央	mdi
崦	mdj
盎	mdl
颛	mdm
炭	mdo
鸯	mdq
屵	mdr
崎	mds
髓	med
崩	mee
冑	mef
胄	mef
骨	mef
岄	meg
髁	mej
髑	mel
㲘	men
髅	meo
髋	mep
骶	meq
屴	mer
骺	mer
骼	met
骰	mew
骸	mey
岐	mfc
冃	mfd
冄	mfd
冉	mfd
亗	mff
峙	mff
屽	mfh
巅	mfh
周	mfk
曱	mfk
赎	mfn
嵌	mfq
贱	mga
豳	mge
赇	mgi
同	mgk
屿	mgn
峡	mgu
帔	mhb
帱	mhd
帏	mhf
幅	mhg
帧	mhh
帽	mhj
巾	mhk
帼	mhl
冂	mhn
幞	mho
帕	mhr
帐	mht
幢	mhu
帆	mhw
汖	miu
嵴	miw
㞱	mjf
则	mjh
則	mjh
赐	mjq
岿	mjv
冋	mkd
贶	mkq
崮	mld
岬	mlh
崽	mln
峀	mmf
岫	mmg
屾	mmh
山	mmm
岘	mmq
岗	mmr
罂	mmt
婴	mmv
賏	mmy
岷	mna
㐕	mnb
岂	mnb
嵋	mnh
剀	mnj
觊	mnm
乢	mnn
屺	mnn
囘	mnv
凯	mnw
赆	mny
赕	moo
嶙	moq
嵝	mov
廸	mpd
迪	mpd
崇	mpf
贮	mpg
䢙	mpi
辿	mpk
㞫	mpu
崆	mpw
见	mqb
购	mqc
赡	mqd
崟	mqf
崯	mqg
峋	mqj
岣	mqk
峁	mqt
岁	mqu
峥	mqv
贩	mrc
崤	mrd
岴	mrg
岶	mrg
岓	mrh
冈	mri
罓	mri
刚	mrj
嵬	mrq
网	mrr
赙	msf
岢	msk
崾	msv
䝵	msy
峬	msy
账	mta
峰	mtd
赂	mtk
屹	mtn
贬	mtp
峨	mtr
嵊	mtu
巍	mtv
敗	mty
败	mty
嵯	mua
岦	muf
㟄	muh
峷	muj
嶂	muj
赔	muk
赚	muv
嵫	mux
罔	muy
屶	mvr
峎	mvu
赊	mwf
嶝	mwg
内	mwi
㞦	mwn
岚	mwr
㞤	mwu
肉	mww
崔	mwy
嶷	mxt
㟂	mxy
崞	myb
丹	myd
彤	mye
訔	myf
嵩	mym
赅	myn
㞵	myu
㞶	myy
展	nae
惬	nag
羾	nag
异	naj
羿	naj
懵	nal
屉	nan
怄	nar
懂	nat
民	nav
殿	naw
慌	nay
孱	nbb
慑	nbc
㞌	nbd
䣁	nbh
邔	nbh
屈	nbm
忚	nbn
屙	nbs
怶	nby
翍	nby
惨	ncd
怿	ncg
㞋	nci
怡	nck
㞎	ncv
悛	ncw
惰	nda
居	ndd
怙	ndg
怀	ndh
剧	ndj
怖	ndm
忧	ndn
恢	ndo
忕	ndy
毣	neb
忇	net
尾	nev
愤	nfa
层	nfc
懦	nfd
恃	nff
㤌	nfg
忓	nfh
慎	nfh
屚	nfi
慰	nfi
卂	nfk
迅	nfp
怃	nfq
屠	nft
导	nfu
忖	nfy
怽	nfy
屋	ngc
刁	ngd
情	nge
䍿	ngf
忹	ngg
怔	ngh
恒	ngj
丮	ngk
司	ngk
怦	ngu
愫	ngx
眉	nhd
	nhd
胥	nhe
遐	nhf
丑	nhg
疋	nhi
蛋	nhj
丩	nhk
鹛	nhq
惧	nhw
疏	nhy
悄	nie
恍	nig
尿	nii
氹	nii
惝	nim
犀	nit
悭	njc
悍	njf
怛	njg
惕	njq
惺	njt
憬	njy
悒	nkc
吢	nkf
忡	nkh
愕	nkk
臂	nku
翼	nla
乪	nld
屇	nld
怬	nlg
悃	nls
愣	nly
届	nmd
惆	nmf
怞	nmg
恫	nmg
刷	nmh
屃	nmi
屓	nmi
㞯	nmj
恻	nmj
恺	nmn
惘	nmu
巽	nna
毋	nnd
己	nng
书	nnh
局	nnk
乙	nnl
忆	nnn
忋	nnn
忌	nnu
乜	nnv
快	nnw
怩	nnx
㤈	nny
羽	nny
惦	noh
屎	noi
迉	npe
恽	npl
惍	nqg
恂	nqj
惚	nqr
習	nrf
怕	nrg
忻	nrh
忾	nrn
愧	nrq
恓	nsg
忊	nsh
杘	nsi
憷	nss
䎍	nsy
怵	nsy
悑	nsy
怅	nta
悸	ntb
发	ntc
恬	ntd
必	nte
忏	ntf
性	ntg
屣	nth
虱	ntj
属	ntk
恤	ntl
懊	ntm
愀	nto
履	ntt
悔	ntx
改	nty
攺	nty
屏	nua
㞐	nud
习	nud
翌	nuf
㥃	nug
翋	nug
飞	nui
惮	nuj
屖	nuk
悦	nuk
憎	nul
羼	nuu
慊	nuv
悌	nux
悯	nuy
慨	nva
妀	nvg
怊	nvk
忉	nvt
尻	nvv
恨	nvy
怆	nwb
忪	nwc
戮	nwe
愉	nwg
乆	nwi
夬	nwi
凥	nwv
惟	nwy
憴	nxg
怫	nxj
惯	nxm
尼	nxv
屁	nxx
忄	nyh
㣺	nyi
乄	nyi
尺	nyi
昼	nyj
咫	nyk
懔	nyl
忙	nyn
迟	nyp
恼	nyr
㤃	nyt
尽	nyu
翠	nyw
忟	nyy
度	oac
䉺	oag
灴	oag
㡲	oai
灷	oaj
廑	oak
炬	oan
庶	oao
烧	oat
粪	oaw
籽	obg
邝	obh
邩	obh
邺	obh
灺	obn
鬯	obx
烃	oca
糁	ocd
広	oci
粑	ocn
糊	ode
䊀	odg
炻	odg
庆	odi
庵	odj
烦	odm
类	odu
庞	odx
㶲	oeh
爝	oel
粍	oen
庾	oew
庋	ofc
庄	ofd
㶰	ofg
灶	ofg
粓	ofg
㶥	ofh
籵	ofh
炜	ofn
庑	ofq
煤	ofs
烤	oft
籿	ofy
炖	ogb
粳	ogj
焐	ogk
炳	ogm
廒	ogq
焯	ohj
店	ohk
黻	oid
黼	ois
炒	oit
黹	oiu
爆	oja
焊	ojf
灲	ojh
熳	ojl
煜	oju
烛	ojy
炽	okw
烟	old
畨	olf
煨	olg
畑	olg
炠	olh
库	olk
庘	olk
庫	olk
庙	omd
粙	omg
灿	omh
籼	omh
炯	omk
㐘	onb
糈	onh
応	oni
废	ont
炔	onw
烬	ony
郯	oob
剡	ooj
火	ooo
炎	oou
糖	oov
炏	ooy
烷	opf
煊	opg
迷	opi
熔	opw
灮	oqb
燃	oqd
焰	oqe
遴	oqg
焕	oqm
炮	oqn
炊	oqw
㶤	oqy
灼	oqy
烯	ord
粕	org
䉼	orh
炘	orh
庍	ork
庳	ort
粞	osg
灯	osh
床	osi
庯	osi
庁	osk
麻	oss
䊇	osy
炑	osy
烳	osy
烽	otd
糙	otf
炸	oth
烙	otk
燠	otm
烁	otn
燔	oto
烀	otu
敉	oty
炇	oty
秌	oty
㡴	oud
烂	oud
燧	oue
料	ouf
粒	oug
烊	ouh
庠	ouk
焖	oun
廉	ouv
糍	oux
㶢	ovb
庸	ove
娄	ovf
籹	ovg
唐	ovh
㡾	ovi
康	ovi
煺	ovp
灱	ovt
庚	ovw
炝	owb
庂	owi
籶	own
糇	own
庥	ows
粉	owv
座	oww
烨	owx
焓	owy
糨	oxk
庀	oxv
庇	oxx
廓	oyb
㢇	oyd
廪	oyl
炉	oyn
米	oyt
熵	oyu
粮	oyv
炕	oyw
炫	oyx
灬	oyy
炆	oyy
宦	pah
寞	paj
宽	pam
寒	paw
字	pbf
㝋	pbj
㝊	pcu
宏	pdc
寡	pde
㝒	pdf
宕	pdf
豁	pdh
寄	pds
宊	pdu
寮	pdu
宠	pdx
宒	peb
肎	pef
宜	peg
农	pei
宗	pfi
完	pfq
守	pfu
室	pgc
㝉	pgf
宇	pgf
定	pgh
宣	pgj
富	pgk
寅	pgm
写	pgn
宝	pgy
㓀	phu
㲾	piu
幂	pjd
寓	pjm
冥	pju
宴	pjv
郓	plb
寰	plg
军	plj
軍	plj
宙	pmf
冚	pmj
甯	pne
官	pnf
逭	pnp
密	pnt
寥	pnw
廴	pny
冞	pou
宩	pou
灾	pou
㝎	ppu
冤	pqk
鸩	pqq
冘	pqv
宁	psj
宋	psu
宅	pta
宪	ptf
牢	ptg
褡	pua
被	pub
衩	puc
衫	pue
褚	puf
袜	pug
补	puh
裆	pui
宰	puj
裎	puk
裢	pul
袖	pum
袂	pun
裤	puo
袍	puq
裨	pur
襟	pus
袄	put
宍	puu
袢	puu
初	puv
裕	puw
襁	pux
衤	puy
宄	pvb
安	pvf
案	pvs
冗	pwb
宂	pwb
突	pwd
穷	pwe
罕	pwf
窥	pwg
窠	pwj
窝	pwk
帘	pwm
窟	pwn
窭	pwo
窕	pwq
窳	pwr
窗	pwt
㓁	pwu
穴	pwu
究	pwv
容	pww
穹	pwx
鹤	pwy
它	pxb
宆	pxb
祁	pyb
祷	pyd
祖	pye
㝘	pyf
福	pyg
祯	pyh
神	pyj
祝	pyk
视	pym
冖	pyn
祗	pyq
㝑	pyr
祈	pyr
祚	pyt
祥	pyu
禄	pyv
宀	pyy
锘	qad
釭	qag
铘	qah
错	qaj
钷	qak
锚	qal
钺	qan
铹	qap
铙	qat
氏	qav
镬	qaw
邸	qay
鈛	qay
镊	qbc
釨	qbg
鉺	qbg
铒	qbg
卬	qbh
夘	qbh
邜	qbh
釕	qbh
钌	qbh
锰	qbl
夗	qbn
怨	qbn
釶	qbn
鸳	qbq
锕	qbs
釢	qbt
鈹	qby
铍	qby
色	qcb
铎	qcg
勾	qci
鈀	qcn
钯	qcn
钗	qcy
危	qdb
钹	qdc
铕	qde
锛	qdf
鈷	qdg
鉐	qdg
钴	qdg
锲	qdh
钸	qdm
铖	qdn
厃	qdr
铸	qdt
镣	qdu
詹	qdw
釱	qdy
钛	qdy
臽	qef
锊	qef
鈅	qeg
钥	qeg
锼	qeh
觥	qei
角	qej
觖	qen
觚	qer
觫	qes
釛	qet
釤	qet
钐	qet
斛	qeu
解	qev
勻	qfd
釷	qfg
鉗	qfg
钍	qfg
钳	qfg
㚈	qfh
針	qfh
釬	qfh
针	qfh
镭	qfl
锗	qft
印	qgb
鲐	qgc
鸟	qgd
鲵	qge
鱼	qgf
鲡	qgg
舛	qgh
鲁	qgj
鳄	qgk
鳃	qgl
鲷	qgm
鲺	qgn
鳞	qgo
鸵	qgp
鲍	qgq
鳇	qgr
桀	qgs
稣	qgt
鲜	qgu
鲫	qgv
鲶	qgw
鈇	qgy
鲸	qgy
䀏	qhd
䤠	qhg
鉬	qhg
钼	qhg
亇	qhj
钻	qhk
外	qhy
釙	qhy
钋	qhy
销	qie
鼗	qif
玺	qig
兆	qii
锁	qim
铴	qin
逃	qip
钞	qit
尔	qiu
淾	qiu
铛	qiv
釥	qiy
郇	qjb
铿	qjc
旬	qjd
锂	qjf
鈤	qjg
钽	qjg
釗	qjh
钊	qjh
镘	qjl
龟	qjn
锡	qjq
锞	qjs
锟	qjx
鉵	qjy
句	qkd
象	qke
名	qkf
釦	qkg
锃	qkg
釧	qkh
钏	qkh
铝	qkk
锅	qkm
免	qkq
甸	qld
鈿	qlg
钿	qlg
鉀	qlh
钾	qlh
锶	qln
链	qlp
锣	qlq
镙	qlx
奂	qmd
鈾	qmg
铀	qmg
铡	qmj
岛	qmk
島	qmk
铠	qmn
钢	qmr
負	qmu
负	qmu
钠	qmw
鋇	qmy
钡	qmy
饶	qna
饣	qnb
饴	qnc
锯	qnd
馁	qne
饽	qnf
䦀	qng
鈻	qng
饯	qng
钮	qnh
蚀	qnj
馈	qnk
釓	qnn
釔	qnn
釲	qnn
钆	qnn
钇	qnn
馆	qnp
饮	qnq
饭	qnr
馇	qns
饰	qnt
饼	qnu
包	qnv
饥	qnw
铌	qnx
鈊	qny
镀	qoa
匊	qoi
灳	qoi
烏	qoi
鳥	qoi
锬	qoo
炙	qou
魚	qou
镛	qov
镳	qox
鈥	qoy
銤	qoy
钬	qoy
镔	qpr
铵	qpv
镲	qpw
铊	qpx
钩	qqc
鍂	qqg
镥	qqg
匇	qqi
铫	qqi
铭	qqk
金	qqq
锪	qqr
铆	qqt
多	qqu
铮	qqv
钦	qqw
釸	qqy
钓	qqy
匈	qrb
钣	qrc
勿	qre
鉑	qrg
铂	qrg
釿	qrh
匁	qri
刎	qrj
锦	qrm
忽	qrn
锨	qrq
铩	qrs
匆	qry
镖	qsf
钵	qsg
釘	qsh
钉	qsh
匍	qsi
镡	qsj
钶	qsk
枭	qsu
梟	qsu
鈢	qsy
鋪	qsy
铺	qsy
猫	qta
犯	qtb
犸	qtc
锋	qtd
狙	qte
猿	qtf
铁	qtg
锻	qth
独	qtj
铬	qtk
猥	qtl
狈	qtm
儿	qtn
勹	qtn
	qtn
狄	qto
狞	qtp
狗	qtq
狐	qtr
獭	qts
犭	qtt
狡	qtu
狠	qtv
猴	qtw
猕	qtx
狱	qty
鉌	qty
匀	qud
钭	quf
鉝	qug
鍆	qug
镁	qug
鋅	quh
锌	quh
镜	quj
锐	quk
钔	qun
镨	quo
锵	quq
铰	qur
镧	qus
铲	qut
镒	quw
锑	qux
邹	qvb
刍	qvf
釹	qvg
钕	qvg
铷	qvk
锱	qvl
急	qvn
釚	qvn
锓	qvp
煞	qvt
釖	qvt
勼	qvv
雏	qvw
銀	qvy
银	qvy
凫	qwb
鳬	qwb
铨	qwg
勽	qwi
铅	qwk
釠	qwn
欠	qwu
锉	qww
铧	qwx
釟	qwy
锥	qwy
镄	qxj
镪	qxk
匂	qxv
鉧	qxy
镦	qyb
铳	qyc
訇	qyd
铱	qye
䚻	qyf
久	qyi
勺	qyi
夊	qyi
镶	qyk
镐	qym
灸	qyo
鈁	qyt
钫	qyt
镑	qyu
贸	qyv
钪	qyw
铉	qyx
鈫	qyy
拭	raa
皂	rab
撒	rae
扛	rag
措	raj
描	ral
拒	ran
捞	rap
抠	rar
挠	rat
拱	raw
找	ray
揶	rbb
氖	rbe
挕	rbg
㧄	rbh
邤	rbh
邱	rbh
拯	rbi
凶	rbk
拙	rbm
扡	rbn
扔	rbt
披	rby
氢	rca
掇	rcc
掺	rcd
捅	rce
择	rcg
反	rci
抬	rck
把	rcn
皅	rcn
返	rcp
挨	rct
㿝	rcu
摊	rcw
払	rcy
瓜	rcy
扼	rdb
拔	rdc
肴	rde
挎	rdf
拓	rdg
掩	rdj
希	rdm
扰	rdn
挞	rdp
氪	rdq
掎	rds
㚖	rdu
撩	rdu
捧	rdw
拢	rdx
㧋	rdy
㧔	rdy
撬	ree
捋	ref
㧮	reg
抈	reg
援	reg
拥	reh
㧌	ren
㿞	ren
授	rep
㔕	ret
劤	ret
劧	ret
劰	ret
扐	ret
摇	ret
技	rfc
持	rff
扗	rfg
拑	rfg
扞	rfh
盾	rfh
擀	rfj
皁	rfj
拮	rfk
擂	rfl
抟	rfn
挝	rfp
抚	rfq
拷	rft
攉	rfw
抺	rfy
卮	rgb
掭	rgd
氰	rge
皇	rgf
抂	rgg
撵	rgg
扌	rgh
氩	rgo
遑	rgp
抹	rgs
挟	rgu
捷	rgv
扶	rgy
排	rhd
掳	rhe
看	rhf
扯	rhg
攫	rhh
掉	rhj
拈	rhk
摅	rhn
扑	rhy
捎	rie
撑	rip
抄	rit
泉	riu
挡	riv
撮	rjb
氜	rjd
捏	rjf
抇	rjg
担	rjg
刈	rjh
刏	rjh
氘	rjk
氲	rjl
拽	rjn
揭	rjq
揽	rjt
揖	rkb
挹	rkc
捐	rke
扣	rkg
捉	rkh
氚	rkk
损	rkm
氤	rld
摆	rlf
畠	rlf
擐	rlg
押	rlh
捙	rlh
捆	rls
撂	rlt
摞	rlx
揣	rmd
抽	rmg
帛	rmh
岳	rmj
氙	rmk
撄	rmm
皑	rmn
摧	rmw
抿	rna
掘	rnb
据	rnd
䎅	rng
挧	rng
握	rng
扭	rnh
忥	rni
擗	rnk
扎	rnn
癿	rnn
扬	rnr
拨	rnt
㣻	rnu
摒	rnu
抉	rnw
抋	rny
拟	rny
摭	roa
掂	roh
氣	roi
氮	roo
扩	rot
搂	rov
廹	rpd
迫	rpd
皖	rpf
揎	rpg
近	rpk
挥	rpl
摈	rpr
拧	rps
按	rpv
控	rpw
抵	rqa
抑	rqb
皃	rqb
鬼	rqc
掐	rqe
捦	rqg
撸	rqg
挑	rqi
拘	rqk
捣	rqm
抱	rqn
掬	rqo
揿	rqq
掏	rqt
挣	rqv
欣	rqw
的	rqy
扳	rrc
㿟	rrg
拍	rrg
拞	rrg
折	rrh
抙	rrh
斦	rrh
気	rri
蜇	rrj
哲	rrk
㧉	rrn
逝	rrp
掀	rrq
白	rrr
捭	rrt
爻	rru
拆	rry
弑	rsa
氥	rsd
搏	rsf
拪	rsg
打	rsh
刹	rsj
杀	rsu
捕	rsy
托	rta
拖	rtb
括	rtd
氕	rte
卑	rtf
气	rtg
丘	rth
播	rto
乒	rtr
斤	rtt
	rtt
搬	rtu
㐅	rty
乂	rty
敀	rty
拼	rua
搠	rub
拦	rud
抖	ruf
拉	rug
捫	rug
撞	ruj
氧	ruk
扪	run
皎	rur
撙	rus
搁	rut
接	ruv
抛	rve
扫	rvg
氯	rvi
招	rvk
扏	rvn
殷	rvn
拶	rvq
㧅	rvt
捃	rvt
执	rvy
拫	rvy
抢	rwb
投	rwc
拊	rwf
捡	rwg
㒵	rwu
兵	rwu
氛	rwv
挫	rww
抡	rwx
扒	rwy
皀	rxb
拗	rxe
掼	rxm
㧈	rxn
搦	rxu
批	rxx
拇	rxy
撤	ryc
拄	ryg
斥	ryi
挤	ryj
攘	ryk
擅	ryl
护	ryn
㧍	ryt
邀	ryt
乓	ryu
抗	ryw
摔	ryx
抆	ryy
械	saa
栉	sab
杢	saf
杠	sag
榧	sah
栋	sai
槿	sak
横	sam
柜	san
檬	sap
柩	saq
枢	sar
桡	sat
椰	sbb
楹	sbc
椭	sbd
李	sbf
杍	sbg
栮	sbg
䢶	sbh
邒	sbh
郙	sbh
杝	sbn
㭁	sbt
极	sby
柀	sby
桶	sce
树	scf
杩	scg
杷	scn
梭	scw
权	scy
枥	sde
㭅	sdg
枯	sdg
柘	sdg
杯	sdh
椅	sds
梆	sdt
䙲	sdu
橛	sdu
棋	sdw
栊	sdx
杕	sdy
杖	sdy
枤	sdy
桴	seb
棚	see
枂	seg
桕	seg
枷	sek
枆	sen
朸	set
杉	set
鄄	sfb
枝	sfc
垔	sff
桂	sff
杜	sfg
柑	sfg
杆	sfh
标	sfi
桔	sfk
檑	sfl
楠	sfm
椟	sfn
材	sft
尃	sfu
樯	sfu
棱	sfw
㭑	sfy
村	sfy
栈	sga
酏	sgb
酸	sgc
本	sgd
酉	sgd
酹	sge
酣	sgf
枉	sgg
丁	sgh
醒	sgj
梧	sgk
槽	sgm
配	sgn
醚	sgo
酡	sgp
酌	sgq
酗	sgr
酊	sgs
酷	sgt
枰	sgu
酚	sgw
酯	sgx
枎	sgy
酬	sgy
杫	shg
相	shg
椒	shi
棹	shj
桢	shm
想	shn
朴	shy
梢	sie
榉	sig
桫	sii
樘	sip
杪	sit
㭂	siy
東	sjd
杳	sjf
覃	sjj
榻	sjn
棵	sjs
槛	sjt
棍	sjx
楫	skb
可	skd
束	skd
杏	skf
枵	skg
杊	skh
剌	skj
榀	skk
速	skp
赖	skq
歌	sks
整	skt
枳	skw
柬	sld
㭗	slf
盙	slf
柶	slg
柙	slh
椤	slq
楞	sly
柚	smg
杣	smh
刺	smj
樱	smm
桤	smn
枧	smq
棘	sms
賈	smu
贾	smu
朿	smv
枘	smw
梖	smy
㐉	snb
乶	snb
朰	snb
橄	snb
椐	snd
㭒	sng
栩	sng
楣	snh
樨	sni
札	snn
杞	snn
杨	snr
杺	sny
桩	sof
䙳	sou
杰	sou
粟	sou
楼	sov
廼	spd
迺	spd
棕	spf
楦	spg
逋	spi
棺	spn
槟	spr
柠	sps
桉	spv
榨	spw
柁	spx
柢	sqa
桅	sqd
桷	sqe
橹	sqg
桃	sqi
橡	sqk
柳	sqt
榴	sqy
板	src
槔	srd
柏	srg
杽	srh
析	srh
棉	srm
槐	srq
攀	srr
檄	sry
郴	ssb
彬	sse
禁	ssf
栖	ssg
朾	ssh
楂	ssj
柯	ssk
楝	ssl
楚	ssn
焚	sso
梦	ssq
森	sss
栗	ssu
婪	ssv
梵	ssw
㭪	ssy
林	ssy
枨	sta
桥	std
株	stf
桁	stg
柞	sth
格	stk
榭	stm
槌	stn
楸	sto
覆	stt
䅇	stu
梅	stx
枚	sty
柇	sty
槎	sua
栏	sud
柆	sug
椚	sug
样	suh
梓	suh
樟	suj
榈	suk
校	sur
樽	sus
梯	sux
概	sva
要	svf
楗	svg
棣	svi
朹	svn
棂	svo
朷	svt
根	svy
枪	swb
松	swc
桧	swf
检	swg
机	swn
枫	swr
枞	sww
桦	swx
朲	swy
朳	swy
椎	swy
椽	sxe
朼	sxn
杛	sxn
㭃	sxy
栂	sxy
椁	syb
梳	syc
槠	syf
柱	syg
术	syi
榱	syk
檀	syl
柿	sym
核	syn
述	syp
旉	syr
枋	syt
榜	syu
榔	syv
杭	syw
筇	tab
箬	tad
笁	taf
筐	tag
篚	tah
升	tak
簧	tam
簪	taq
䇝	tau
乇	tav
筑	taw
㐌	tbb
竾	tbb
䇯	tbf
季	tbf
秄	tbg
䄦	tbh
䄬	tbn
彵	tbn
透	tbp
秀	tbr
䄧	tbt
彼	tby
秛	tby
径	tca
笆	tcb
笃	tcg
笞	tck
么	tcu
私	tcy
矩	tda
舌	tdd
䇢	tdf
甜	tdf
䄷	tdg
短	tdg
秙	tdg
逢	tdh
夭	tdi
乔	tdj
岙	tdm
乱	tdn
适	tdp
舐	tdq
敌	tdt
矢	tdu
箕	tdw
笼	tdx
㣕	tdy
笔	teb
稻	tee
䄴	teg
租	teg
甪	tek
笳	tek
秏	ten
笾	tep
㣊	ter
务	ter
竻	ter
徭	tet
缺	tfb
丢	tfc
壬	tfd
	tfd
歃	tfe
䇞	tff
玍	tff
竺	tff
秆	tfh
朱	tfi
午	tfj
竿	tfj
千	tfk
德	tfl
迁	tfp
先	tfq
籍	tfs
箸	tft
乖	tfu
笺	tga
生	tgd
箐	tge
竽	tgf
彺	tgg
征	tgh
失	tgi
䄵	tgj
夅	tgj
年	tgj
牛	tgk
舞	tgl
制	tgm
迭	tgp
行	tgs
秤	tgu
䄮	tgy
算	tha
自	thd
䇛	thf
乍	thf
䄳	thg
片	thg
衢	thh
处	thi
昝	thj
咎	thk
鼻	thl
息	thn
臬	ths
竹	tht
稍	tie
衍	tig
徜	tim
箔	tir
簿	tis
尓	tiu
香	tjf
利	tjh
䖝	tji
梨	tjs
复	tjt
㕿	tkf
各	tkf
和	tkg
种	tkh
稆	tkk
禹	tkm
积	tkw
篾	tla
甶	tld
血	tld
备	tlf
盉	tlf
笽	tlf
箅	tlg
笚	tlj
徊	tlk
惫	tln
粤	tlo
囱	tlq
囟	tlr
衅	tlu
稷	tlw
射	tmd
笛	tmf
㣙	tmg
微	tmg
秞	tmg
币	tmh
秈	tmh
㟀	tmj
屲	tmj
向	tmk
奥	tmo
秽	tmq
筫	tmu
乞	tnb
戶	tne
阜	tnf
笥	tng
䄫	tnn
乌	tnn
追	tnp
秘	tnt
释	toc
釆	toi
番	tol
釉	tom
悉	ton
夈	tou
篓	tov
簏	tox
秋	toy
稼	tpg
管	tpn
箢	tpq
乏	tpu
箜	tpw
禿	tqb
衡	tqd
衔	tqg
称	tqi
徇	tqj
笱	tqk
移	tqq
笏	tqr
黎	tqt
箍	tra
箨	trc
循	trf
䄸	trg
徨	trg
篪	trh
穆	tri
筘	trk
我	trn
籀	trq
稗	trt
徼	try
䇴	tsf
䄽	tsg
徆	tsg
笨	tsg
㣔	tsh
箱	tsh
簟	tsj
籁	tsk
策	tsm
篥	tss
条	tsu
秫	tsy
秿	tsy
笑	ttd
筅	ttf
御	ttg
	ttg
筵	tth
篦	ttl
秭	ttn
禾	ttt
秝	tty
艨	tua
艋	tub
乊	tue
箭	tue
笠	tuf
艚	tug
徉	tuh
舟	tui
简	tuj
税	tuk
盘	tul
舰	tum
艉	tun
舵	tup
舶	tur
舸	tus
艇	tut
冬	tuu
船	tuw
乘	tux
航	tuy
秉	tvd
委	tvf
律	tvg
箫	tvh
笤	tvk
簋	tvl
逶	tvp
魏	tvr
笋	tvt
很	tvy
筏	twa
秃	twb
役	twc
颓	twd
符	twf
徐	twg
筱	twh
黍	twi
篌	twn
秂	twu
凢	twv
処	twv
稚	twy
龜	txd
篆	txe
第	txh
系	txi
敏	txt
每	txu
筚	txx
毓	txy
䇾	tyf
往	tyg
入	tyi
穰	tyk
稿	tym
篇	tyn
籴	tyo
篱	tyr
䄱	tyt
彷	tyt
稂	tyv
疘	uad
差	uaf
冮	uag
疟	uag
冻	uai
并	uaj
竎	uaj
阈	uak
癀	uam
迸	uap
瘩	uaw
䇅	uay
戕	uay
聞	ubd
闻	ubd
疓	ube
疲	ubi
兯	ubj
疖	ubk
疗	ubk
瘾	ubq
塑	ubt
痉	uca
冯	ucg
冶	uck
羓	ucn
兖	ucq
疤	ucv
竣	ucw
瘙	ucy
郑	udb
闳	udc
㽽	udd
䦒	udd
閆	udd
闫	udd
疬	ude
兰	udf
㓈	udg
䇉	udg
减	udg
痞	udh
头	udi
阉	udj
疣	udn
送	udp
关	udu
凑	udw
状	udy
狀	udy
閒	ued
閰	ued
疽	ueg
瘦	ueh
痈	uek
㲔	uen
竓	uen
遂	uep
阋	ueq
劷	uet
羏	uet
㒸	ueu
豙	ueu
閐	uev
毅	uew
阖	ufc
㽵	ufd
䦌	ufd
疳	ufd
闺	uff
壮	ufg
壯	ufg
癫	ufh
竍	ufh
疛	ufi
斗	ufk
閈	ufk
闬	ufk
痣	ufn
闭	uft
凌	ufw
装	ufy
卷	ugb
閂	ugd
閏	ugd
闩	ugd
闰	ugd
靖	uge
	ugf
豢	ugg
症	ugh
	ugi
养	ugj
半	ugk
盖	ugl
病	ugm
恙	ugn
痖	ugo
冽	ugq
拳	ugr
桊	ugs
羲	ugt
羡	ugu
券	ugv
痍	ugx
誊	ugy
㾇	uhd
痱	uhd
着	uhf
癯	uhh
䇂	uhj
丫	uhk
疵	uhx
㽷	uii
痧	uii
閖	uii
阔	uit
瘠	uiw
冰	uiy
鄣	ujb
間	ujd
间	ujd
彰	uje
音	ujf
疸	ujg
痋	uji
閩	uji
闽	uji
章	ujj
瘟	ujl
意	ujn
竟	ujq
赣	ujt
韶	ujv
部	ukb
問	ukd
问	ukd
㖖	ukf
咅	ukf
瓿	ukg
冲	ukh
剖	ukj
癌	ukk
总	ukn
竞	ukq
痼	uld
兽	ulg
曾	ulj
㾝	ulk
閘	ulk
閳	ulk
闸	ulk
阃	uls
瘰	ulx
㾄	umd
凋	umf
閴	umi
疝	umk
閊	umk
瘿	umm
癜	una
阚	unb
翊	ung
翔	ung
羞	unh
悶	uni
闷	uni
癖	unk
䇃	unn
乵	unn
疡	unr
㽶	unv
羌	unv
决	unw
並	uof
焛	uoi
疢	uoi
痰	uoo
瘘	uov
羝	uqa
㾣	uqd
䦦	uqd
奖	uqd
阎	uqe
将	uqf
凎	uqg
癣	uqg
浆	uqi
阄	uqj
痪	uqm
疱	uqn
桨	uqs
净	uqv
疚	uqy
郊	urb
瓣	urc
斨	urh
䦐	urk
效	urt
交	uru
閪	usd
瘭	usf
尊	usg
㓅	ush
痡	usi
閑	usi
闲	usi
疔	usk
閅	usk
阑	usl
鹇	usq
新	usr
亲	usu
凇	usw
牀	usy
疾	utd
产	ute
閁	ute
冼	utf
首	uth
痢	utj
阁	utk
疙	utn
疼	utu
痿	utv
䍩	uty
瘥	uua
阙	uub
閚	uud
闁	uud
竝	uug
牂	uuh
辡	uuh
阐	uuj
㾕	uuk
痒	uuk
痫	uus
妾	uvf
妆	uvg
妝	uvg
䦘	uvi
痕	uvi
兼	uvj
阀	uwa
疮	uwb
疫	uwc
疹	uwe
瘵	uwf
痊	uwg
閃	uwi
闪	uwi
疥	uwj
益	uwl
瘊	uwn
竌	uwn
疯	uwr
痤	uww
冷	uwy
閄	uwy
邶	uxb
背	uxe
弟	uxh
冀	uxl
北	uxn
凝	uxt
辫	uxu
疕	uxv
兹	uxx
䍭	uxy
訚	uyd
誾	uyd
閍	uye
冫	uyg
门	uyh
閔	uyi
闵	uyi
凛	uyl
闹	uym
阂	uyn
丷	uyt
羊	uyt
辩	uyu
阆	uyv
瘁	uyw
痃	uyx
妅	vag
姬	vah
嫫	vaj
媾	vam
妪	var
娆	vat
㜽	vbf
㛅	vbg
好	vbg
即	vbh
邚	vbh
她	vbn
婀	vbs
奶	vbt
孥	vcb
驽	vcc
努	vce
始	vck
帑	vcm
妑	vcn
怒	vcn
厹	vcu
弩	vcx
奴	vcy
娠	vdf
妬	vdg
姑	vdg
㚑	vdu
嫂	veh
㚪	ven
嫒	vep
妓	vfc
垦	vff
姏	vfg
奸	vfh
卆	vfj
嬉	vfk
妩	vfq
媒	vfs
姥	vft
寻	vfu
妹	vfy
妍	vga
婧	vge
嫣	vgh
聿	vgk
娅	vgo
婕	vgv
姨	vgx
妋	vgy
肀	vhk
隶	vii
剥	vij
逮	vip
妙	vit
录	viu
旭	vjd
旮	vjf
妲	vjg
娼	vjj
媪	vjl
巢	vjs
邵	vkb
邕	vkc
娟	vke
召	vkf
叴	vkf
如	vkg
娲	vkm
恕	vkn
迢	vkp
絮	vkx
甾	vlf
㚼	vlg
邋	vlr
嫘	vlx
妯	vmg
奾	vmh
㞪	vmj
姗	vmm
㛝	vmy
㐇	vnb
娓	vne
㚶	vng
娜	vng
媚	vnh
妃	vnn
刀	vnt
㣽	vnu
恳	vnu
妮	vnx
姒	vny
嬷	vos
㚧	vot
灵	vou
災	vou
辺	vpe
嫁	vpg
退	vpi
婶	vpj
帚	vpm
婉	vpq
嫔	vpr
姹	vpt
巡	vpv
廵	vpv
鸠	vqg
姚	vqi
娩	vqk
夛	vqu
妁	vqy
㚱	vrg
妡	vrh
嫖	vsf
㛉	vsg
奵	vsh
嫩	vsk
杂	vsu
妖	vtd
尹	vte
妊	vtf
姓	vtg
媳	vth
君	vtk
媲	vtl
九	vtn
娥	vtr
姀	vty
姘	vua
㛙	vuh
婵	vuj
姣	vur
娴	vus
嫉	vut
娣	vux
㚣	vvf
奻	vvg
妇	vvg
女	vvv
刅	vwi
妣	vxx
姆	vxy
訄	vyd
妫	vye
娮	vyg
丸	vyi
刃	vyi
刄	vyi
嬗	vyl
忍	vyn
婷	vyp
妨	vyt
嫡	vyu
娘	vyv
妏	vyy
偌	wad
仝	waf
仜	wag
伢	wah
借	waj
儆	waq
伛	war
侥	wat
供	waw
伐	way
戗	wba
仓	wbb
仔	wbg
佴	wbg
䢳	wbh
创	wbj
他	wbn
仍	wbt
佊	wby
颂	wcd
俑	wce
瓮	wcg
凤	wci
翁	wcn
俟	wct
公	wcu
殳	wcu
俊	wcw
仅	wcy
仏	wcy
佐	wda
侑	wde
侉	wdf
仨	wdg
估	wdg
佦	wdg
佰	wdj
佑	wdk
优	wdn
倚	wds
做	wdt
僚	wdu
傣	wdw
㐲	wdy
伏	wdy
俘	web
䏌	wef
仴	weg
佣	weh
伽	wek
倪	weq
㐱	wer
仂	wet
偾	wfa
会	wfc
儒	wfd
佳	wff
仁	wfg
仕	wfg
佄	wfg
什	wfh
仠	wfh
祭	wfi
仐	wfj
癷	wfj
舍	wfk
传	wfn
佬	wft
佞	wfv
付	wfy
佅	wfy
倒	wgc
癸	wgd
愈	wge
亼	wgf
全	wgf
仼	wgg
伍	wgg
剑	wgi
便	wgj
使	wgk
僵	wgl
债	wgm
兮	wgn
俨	wgo
例	wgq
余	wgs
侠	wgu
伕	wgy
俳	whd
凪	whd
企	whf
仩	whg
佧	whh
个	whj
侦	whm
候	whn
修	wht
俱	whw
仆	why
俏	wie
倘	wim
尒	wiu
氽	wiu
㲻	wiy
仦	wiy
俚	wjf
但	wjg
伸	wjh
介	wjj
偶	wjm
偈	wjq
倮	wjs
㕣	wkf
㐰	wkg
俣	wkg
促	wkh
侣	wkk
伵	wlg
佃	wlg
伡	wlh
俥	wlh
儡	wll
倜	wmf
伷	wmg
侗	wmg
仙	wmh
仚	wmj
侧	wmj
催	wmw
倔	wnb
倨	wnd
伺	wng
佀	wng
假	wnh
僻	wnk
㐶	wnn
亿	wnn
侯	wnt
亾	wnv
伲	wnx
伈	wny
似	wny
㶡	woi
偻	wov
俯	wow
伙	woy
侎	woy
侬	wpe
倌	wpn
傧	wpr
倥	wpw
佗	wpx
低	wqa
仰	wqb
尣	wqb
儋	wqd
釡	wqf
像	wqk
侈	wqq
偬	wqr
㐴	wqy
爷	wrb
爸	wrc
飕	wre
㒶	wrf
釜	wrf
伯	wrg
㐿	wrh
伒	wrh
飓	wrh
风	wri
㐹	wrn
飚	wro
爹	wrq
斧	wrr
俾	wrt
父	wru
傅	wsf
体	wsg
価	wsg
仃	wsh
凩	wsi
剁	wsj
何	wsk
僳	wso
鸺	wsq
傈	wss
朵	wsu
休	wsy
俌	wsy
伥	wta
仫	wtc
侨	wtd
伤	wte
任	wtf
件	wtg
亻	wth
俐	wtj
傻	wtl
几	wtn
俄	wtr
佟	wtu
倭	wtv
侮	wtx
八	wty
伞	wuf
位	wug
們	wug
佯	wuh
僮	wuj
倍	wuk
僧	wul
们	wun
佼	wur
仒	wuu
颁	wvd
坌	wvf
㚢	wvg
健	wvg
盆	wvl
贫	wvm
仇	wvn
侵	wvp
分	wvr
伊	wvt
仞	wvy
佷	wvy
耸	wwb
俎	wwe
坐	wwf
丛	wwg
价	wwj
谷	wwk
仉	wwn
仌	wwu
份	wwv
众	www
伦	wwx
仈	wwy
从	wwy
仑	wxb
倾	wxd
华	wxf
僶	wxg
佛	wxj
货	wxm
化	wxn
偕	wxx
㑄	wxy
隽	wyb
令	wyc
依	wye
储	wyf
詧	wyf
信	wyg
隹	wyg
凡	wyi
侪	wyj
售	wyk
今	wyn
焦	wyo
停	wyp
仪	wyr
集	wys
仿	wyt
亽	wyu
傍	wyu
食	wyv
伉	wyw
伩	wyy
雠	wyy
绒	xad
缂	xaf
紅	xag
红	xag
练	xan
绕	xat
㝀	xbg
䋙	xbg
䌺	xbg
弭	xbg
鄳	xbh
绌	xbm
䊶	xbn
弛	xbn
毑	xbn
㢰	xby
紴	xby
经	xca
缀	xcc
绎	xcg
绐	xck
弝	xcn
紦	xcn
纾	xcn
弘	xcy
绂	xdc
缛	xdf
缄	xdg
弼	xdj
缅	xdl
绮	xds
绑	xdt
缭	xdu
紎	xdy
绷	xee
蠡	xej
䋃	xen
绶	xep
幼	xet
糼	xet
絼	xet
彖	xeu
绥	xev
纭	xfc
紺	xfg
绀	xfg
㢨	xfh
缜	xfh
续	xfn
鸨	xfq
绪	xft
绫	xfw
紂	xfy
纣	xfy
纯	xgb
㢧	xgd
弖	xgf
纡	xgf
绠	xgj
缰	xgl
绩	xgm
缙	xgo
䊿	xgy
绯	xhd
䊼	xhg
引	xhh
缈	xhi
绰	xhj
弔	xhk
颍	xid
绡	xie
绱	xim
彔	xiu
糸	xiu
㢼	xiy
旨	xjf
缇	xjg
绅	xjh
㔬	xjj
弗	xjk
缦	xjl
费	xjm
艴	xjq
缆	xjt
绲	xjx
缉	xkb
绢	xke
紃	xkh
缱	xkh
缲	xkk
织	xkw
細	xlg
细	xlg
缌	xln
缧	xlx
绸	xmf
䌷	xmg
紬	xmg
	xmg
㢫	xmh
缨	xmm
纲	xmr
貫	xmu
贯	xmu
纳	xmw
缗	xna
䋚	xng
䌻	xng
弓	xng
纠	xnh
乣	xnn
幻	xnn
糺	xnn
紀	xnn
纪	xnn
缪	xnw
缠	xoj
纩	xot
缕	xov
粥	xox
䋛	xoy
绽	xpg
绾	xpn
缤	xpr
缩	xpw
纸	xqa
绝	xqc
䋮	xqg
弥	xqi
绚	xqj
绉	xqv
弧	xrc
絈	xrg
紤	xrh
缴	xry
絤	xsg
糽	xsh
缃	xsh
䊾	xsy
䋠	xsy
张	xta
绣	xtb
疑	xtd
乡	xte
纤	xtf
绛	xtg
缎	xth
络	xtk
匕	xtn
绦	xts
终	xtu
飨	xtw
绊	xug
㢹	xuh
絴	xuh
弹	xuj
缯	xul
绞	xur
缮	xuu
缣	xuv
缢	xuw
绿	xvi
缫	xvj
缁	xvl
䊵	xvn
㓜	xvt
糿	xvt
纫	xvy
绘	xwf
缑	xwn
纷	xwv
纵	xww
纶	xwx
维	xwy
畿	xxa
缘	xxe
毕	xxf
丝	xxg
繩	xxg
绋	xxj
弜	xxn
比	xxn
皆	xxr
纰	xxx
统	xyc
缟	xym
编	xyn
缡	xyr
紡	xyt
纺	xyt
缔	xyu
弦	xyx
紋	xyy
纹	xyy
诫	yaa
诺	yad
訌	yag
讧	yag
讶	yah
谟	yaj
谨	yak
谍	yan
谮	yaq
讴	yar
诬	yaw
谎	yay
郭	ybb
诹	ybc
享	ybf
斈	ybf
斊	ybf
誀	ybg
邡	ybh
亨	ybj
㓙	ybk
诎	ybm
訑	ybn
烹	ybo
鹑	ybq
䚮	ybt
敦	ybt
熟	ybv
詖	yby
诐	yby
弃	yca
育	yce
译	ycg
诒	yck
袤	ycn
诶	yct
詁	ydg
诂	ydg
斋	ydm
诙	ydo
谌	ydw
䛋	ydy
彣	yee
裒	yee
䚴	yeg
诅	yeg
蠃	yej
赢	yem
䚽	yen
䚲	yet
谣	yet
哀	yeu
衣	yeu
嬴	yev
谀	yew
为	yey
诗	yff
詌	yfg
計	yfh
訐	yfh
计	yfh
讦	yfh
讲	yfj
诘	yfk
谳	yfm
读	yfn
谋	yfs
诸	yft
対	yfy
討	yfy
讨	yfy
斌	yga
主	ygd
请	yge
㪯	ygj
语	ygk
评	ygu
谑	yha
诽	yhd
訨	yhg
让	yhg
卞	yhu
訃	yhy
讣	yhy
诮	yie
氷	yii
谠	yip
京	yiu
䚱	yiy
亯	yjf
斉	yjf
齊	yjf
䚯	yjh
刘	yjh
亣	yjj
齐	yjj
谩	yjl
谒	yjq
课	yjs
蚉	yju
吝	ykf
误	ykg
訓	ykh
训	ykh
襄	ykk
识	ykw
谓	yle
亩	ylf
畗	ylf
訵	ylg
䛅	ylh
颤	ylk
谡	ylw
调	ymf
䛆	ymg
訕	ymh
讪	ymh
高	ymk
讷	ymw
㐎	ynb
㐔	ynb
亡	ynb
戾	ynd
户	yne
讯	ynf
詡	yng
诩	yng
盲	ynh
永	yni
启	ynk
遍	ynm
記	ynn
记	ynn
刻	ynt
忞	ynu
悥	ynu
戽	ynu
雇	ynw
房	yny
訫	yny
弈	yoa
孪	yob
变	yoc
奕	yod
蛮	yoj
峦	yom
恋	yon
谈	yoo
迹	yop
銮	yoq
挛	yor
栾	yos
㪰	you
亦	you
娈	yov
弯	yox
詸	yoy
這	ypd
䢍	ype
毫	ype
豪	ypg
这	ypi
膏	ypk
诨	ypl
亭	yps
诧	ypt
诋	yqa
诡	yqd
谄	yqe
谗	yqk
诳	yqt
诌	yqv
离	yrb
诟	yrg
䜣	yrh
訢	yrh
	yrh
义	yri
亵	yrv
诉	yry
訂	ysh
订	ysh
谭	ysj
诃	ysk
谏	ysl
誧	ysy
施	ytb
话	ytd
旅	yte
许	ytf
旆	ytg
诞	yth
谢	ytm
讫	ytn
族	ytt
诿	ytv
诲	ytx
䚺	yty
放	yty
訸	yty
谫	yue
䛨	yuh
詳	yuh
详	yuh
谙	yuj
说	yuk
商	yum
谱	yuo
旁	yup
谘	yuq
谰	yus
谚	yut
谦	yuv
谥	yuw
郎	yvb
朗	yve
良	yvi
诏	yvk
訅	yvn
詪	yvy
亢	ywb
设	ywc
颃	ywd
诊	ywe
诠	ywg
褒	ywk
讥	ywn
讽	ywr
夜	ywt
於	ywu
卒	yww
论	ywx
㫃	ywy
认	ywy
譝	yxg
紊	yxi
诣	yxj
畜	yxl
䚰	yxn
雍	yxt
玄	yxu
谐	yxx
谆	yyb
亠	yyg
誩	yyg
谅	yyi
丶	yyl
乀	yyl
讠	yyn
议	yyr
訪	yyt
访	yyt
谤	yyu
谇	yyw
言	yyy
